area_of_origin,area_of_destination,migrants_1990,migrants_1995,migrants_2000,migrants_2005,migrants_2010,migrants_2015,migrants_2020,increase_1990,migrants_increase_1990_pc,increase_2000,migrants_increase_2000_pc,increase_2010,migrants_increase_2010_pc,increase_2015,migrants_increase_2015_pc,origin_iso,destination_iso,origin_population_2000,origin_population_2010,origin_population_2015,origin_population_2020,destination_population_2000,destination_population_2010,destination_population_2015,destination_population_2020,migrants_origin_100k,migrants_destination_100k
India,United Arab Emirates,458294,667853,915878,1286993,2913858,3184043,3471300,3013006,6.5743954753935245,457584,0.4996123937904393,557442,0.19130719479123554,287257,0.09021768864302399,IND,ARE,1059633675,1240613620,1322866505,1396387127,3275333,8481771,8916899,9287289,248.59152113910886,37376.8922233388
India,United States of America,450406,746337,1048517,1390605,1784284,2389639,2723764,2273358,5.0473528327775385,598111,0.5704351956143773,939480,0.5265305298932232,334125,0.1398223748440664,IND,USA,1059633675,1240613620,1322866505,1396387127,282162411,309327143,320738994,331526933,195.05794255291786,821.5815153696728
Afghanistan,Iran,3980307,2660518,2232283,2376348,2572558,2621236,2710601,-1269706,-0.3189970019900475,-1748024,-0.7830655880101224,138043,0.0536598203033712,89365,0.03409269520180556,AFG,IRN,19542982,28189672,33753499,38972230,65544383,75373855,81790841,87290193,6955.211441582891,3105.275526198
India,Saudi Arabia,906468,929709,978992,1216549,1579235,2003256,2502337,1595869,1.7605353967266357,72524,0.07408027849052903,923102,0.5845247857348653,499081,0.24913490836917498,IND,SAU,1059633675,1240613620,1322866505,1396387127,21547390,29411929,32749848,35997107,179.20080696934124,6951.494740952377
Bangladesh,India,4375155,4127135,3879114,3298833,2855334,2660632,2488471,-1886684,-0.4312267793941015,-496041,-0.12787481883749743,-366863,-0.12848339283600446,-172161,-0.06470680650311655,BGD,IND,129193327,148391139,157830000,167420951,1059633675,1240613620,1322866505,1396387127,1486.355790679985,178.20781586165396
China,Hong Kong,1659157,1772597,1886037,2070537,2260045,2309769,2408447,749290,0.4516088591977733,226880,0.12029456474077656,148402,0.06566329431493621,98678,0.042722021119860905,CHN,HKG,1262645000,1337705000,1379860000,1411100000,6665000,7024200,7291300,7481000,170.67869038338884,32194.18526934902
China,United States of America,773939,1058487,1348465,1607654,1922950,2676697,2184110,1410171,1.8220699564177538,574526,0.4260592599733771,261160,0.1358121636027978,-492587,-0.18402792695624495,CHN,USA,1262645000,1337705000,1379860000,1411100000,282162411,309327143,320738994,331526933,154.78066756431153,658.8031868891931
Philippines,United States of America,912674,1156143,1403834,1596459,1843117,1982369,2061178,1148504,1.2583945636667637,491160,0.3498704262754713,218061,0.1183109916516423,78809,0.039754959848544845,PHL,USA,77958223,94636700,103031365,112190977,282162411,309327143,320738994,331526933,1837.204786976764,621.7226399521513
Myanmar,Thailand,229504,436777,734129,1182070,1658622,1760543,1848270,1618766,7.0533236893474625,504625,0.6873791935749711,189648,0.11434069968926013,87727,0.04982951282644048,MMR,THA,45538332,49390988,51483949,53423198,63066603,68270489,70294397,71475664,3459.6768242889543,2585.873144179535
Indonesia,Saudi Arabia,635007,650793,668666,825998,1070951,1368407,1709318,1074311,1.6918096965860219,33659,0.05033753772436463,638367,0.5960748904478356,340911,0.24912982760246039,IDN,SAU,214072421,244016173,259091970,271857970,21547390,29411929,32749848,35997107,628.7540512422719,4748.487149258967
Afghanistan,Pakistan,3374973,1291867,2069977,1166210,1990641,1710378,1598223,-1776750,-0.5264486560336927,-1304996,-0.630439855128825,-392418,-0.19713147674543025,-112155,-0.06557322416448294,AFG,PAK,19542982,28189672,33753499,38972230,154369924,194454498,210969298,227196741,4100.927763179064,703.4533122990528
India,Pakistan,2818248,2365884,2101039,1998814,1943345,1709217,1597134,-1221114,-0.4332883408415441,-717209,-0.3413592037082605,-346211,-0.17815210371807375,-112083,-0.06557564077586403,IND,PAK,1059633675,1240613620,1322866505,1396387127,154369924,194454498,210969298,227196741,114.37616181920016,702.9739920433101
Pakistan,Saudi Arabia,556715,570555,586225,724160,938913,1187817,1483737,927022,1.6651644018932488,29510,0.050339033647490296,544824,0.5802710155254002,295920,0.24912928506663906,PAK,SAU,154369924,194454498,210969298,227196741,21547390,29411929,32749848,35997107,653.06262469671606,4121.82290093479
Vietnam,United States of America,543262,775967,1013266,1106433,1236000,1300575,1403193,859931,1.58290290872544,470004,0.4638505584910576,167193,0.13526941747572815,102618,0.07890202410472291,VNM,USA,79001142,87411012,92191398,96648685,282162411,309327143,320738994,331526933,1451.8490344695326,423.25158541493215
India,Oman,152554,282987,333881,373411,473206,1076151,1375667,1223113,8.017574104907116,181327,0.5430887052572623,902461,1.9071207888319253,299516,0.27832153666167664,IND,OMN,1059633675,1240613620,1322866505,1396387127,2344253,2881914,4191776,4543399,98.5161617004795,30278.366482890895
Bangladesh,Saudi Arabia,479380,491297,504790,623564,808485,1022812,1277624,798244,1.6651591639200634,25410,0.05033776421878405,469139,0.5802692690649796,254812,0.24912887216810128,BGD,SAU,129193327,148391139,157830000,167420951,21547390,29411929,32749848,35997107,763.120739888761,3549.2407764879554
Indonesia,Malaysia,252710,421423,726961,863998,960819,1171677,1241634,988924,3.913276087214594,474251,0.6523747491268445,280815,0.29226628532533183,69957,0.05970672804877112,IDN,MYS,214072421,244016173,259091970,271857970,22945150,28717731,31068833,33199993,456.7215741366714,3739.8622343083025
India,Kuwait,375183,332377,418664,485921,675347,1061758,1152175,776992,2.070968034265945,43481,0.10385655322645367,476828,0.706048890422257,90417,0.08515782315744265,IND,KWT,1059633675,1240613620,1322866505,1396387127,1934901,2943356,3908743,4360444,82.51114449009097,26423.341292767433
Malaysia,Singapore,195072,431854,710434,818337,971827,1114858,1132924,937852,4.807722276902887,515362,0.7254185469726956,161097,0.16576715814646023,18066,0.01620475432745695,MYS,SGP,22945150,28717731,31068833,33199993,4027887,5076732,5535002,5685807,3412.4224062336402,19925.474079580963
Bangladesh,United Arab Emirates,154869,219911,297620,408976,919365,1004611,1095231,940362,6.071983418243806,142751,0.47964182514615955,175866,0.19129072783932388,90620,0.09020406903766731,BGD,ARE,129193327,148391139,157830000,167420951,3275333,8481771,8916899,9287289,654.1779827782724,11792.795507924864
South Korea,United States of America,568397,725849,886067,990111,1127266,1060019,1038778,470381,0.8275571475570772,317670,0.3585169067350437,-88488,-0.07849788780997564,-21241,-0.02003832006784784,KOR,USA,47008111,49554112,51014947,51836239,282162411,309327143,320738994,331526933,2003.9609740976769,313.3314058680113
Pakistan,United Arab Emirates,158710,225750,305782,383831,836310,913855,996288,837578,5.277411631277173,147072,0.4809701028837538,159978,0.1912903110090756,82433,0.09020358809657987,PAK,ARE,154369924,194454498,210969298,227196741,3275333,8481771,8916899,9287289,438.51333237214,10727.436176477335
Laos,Thailand,165019,205957,289386,540225,829426,899705,941309,776290,4.70424617771287,124367,0.42976163325109024,111883,0.13489208199405373,41604,0.04624182370888236,LAO,THA,5430853,6323418,6787419,7319399,63066603,68270489,70294397,71475664,12860.468461959787,1316.964330684637
Myanmar,Bangladesh,225851,228109,230390,128693,235019,237369,907426,681575,3.0178082009820635,4539,0.019701375927774642,672407,2.8610750620162624,670057,2.8228496560207947,MMR,BGD,45538332,49390988,51483949,53423198,129193327,148391139,157830000,167420951,1698.5617371689355,542.0026553307537
India,United Kingdom,399526,422284,452144,548130,684136,807790,835359,435833,1.0908751870967095,52618,0.11637442938532856,151223,0.2210423073774805,27569,0.03412891964495723,IND,GBR,1059633675,1240613620,1322866505,1396387127,58892514,62766365,65116219,67081234,59.82288033510353,1245.2946229343368
Pakistan,India,1921278,1637255,1353231,1128173,956166,890966,833314,-1087964,-0.5662709925372591,-568047,-0.41977090385898636,-122852,-0.1284839661732377,-57652,-0.06470729522787626,PAK,IND,154369924,194454498,210969298,227196741,1059633675,1240613620,1322866505,1396387127,366.7807893423964,59.67643097586361
China,South Korea,19827,48299,92142,243217,490407,759204,803011,783184,39.50088263479094,72315,0.7848212541512014,312604,0.6374378832276049,43807,0.05770122391346726,CHN,KOR,1262645000,1337705000,1379860000,1411100000,47008111,49554112,51014947,51836239,56.90673942314507,1549.130522374511
China,Japan,150383,222311,335600,648120,687156,714570,775893,625510,4.159446214000253,185217,0.5518980929678189,88737,0.12913661526640238,61323,0.08581804441832151,CHN,JPN,1262645000,1337705000,1379860000,1411100000,126843000,128070000,127141000,126261000,54.984976259655596,614.5151709554019
Nepal,India,518212,591200,664187,764918,841906,784497,733734,215522,0.41589542503840127,145975,0.2197799716043825,-108172,-0.12848465268094061,-50763,-0.06470770442716799,NPL,IND,24559500,27161567,27610325,29348627,1059633675,1240613620,1322866505,1396387127,2500.0624390367566,52.54517073473422
India,Canada,166640,240035,319138,424855,517890,664465,720083,553443,3.3211893903024485,152498,0.4778434407685703,202193,0.39041688389426327,55618,0.08370343057948876,IND,CAN,1059633675,1240613620,1322866505,1396387127,30685730,34005902,35704498,38028638,51.56757650344624,1893.5282404802401
India,Qatar,2738,2975,2769,193404,540914,645577,702013,699275,255.3962746530314,31,0.01119537739256049,161099,0.29782738106242396,56436,0.08741947126369123,IND,QAT,1059633675,1240613620,1322866505,1396387127,645937,1713504,2414573,2760385,50.27352275211859,25431.706084477344
China,Canada,168079,286712,412162,508994,611990,645278,699190,531111,3.159889099768561,244083,0.5922016100465352,87200,0.1424859883331427,53912,0.08354848607886833,CHN,CAN,1262645000,1337705000,1379860000,1411100000,30685730,34005902,35704498,38028638,49.54928778966763,1838.588066183175
Cambodia,Thailand,73756,102948,153382,369213,611508,666096,691776,618020,8.379250501654102,79626,0.5191352309919026,80268,0.13126238740948606,25680,0.03855300136917201,KHM,THA,12118841,14363532,15417523,16396860,63066603,68270489,70294397,71475664,4218.954116824806,967.8483014862232
China,Australia,97526,108346,144690,227561,371550,508870,653232,555706,5.698029243483789,47164,0.3259658580413297,281682,0.7581267662494954,144362,0.28369131605321596,CHN,AUS,1262645000,1337705000,1379860000,1411100000,19028802,22031750,23815995,25649248,46.292396003118135,2546.7881163611505
Philippines,Saudi Arabia,239551,245507,252250,311603,404010,516223,644828,405277,1.6918192785669857,12699,0.05034291377601586,240818,0.5960694042226677,128605,0.24912683084635903,PHL,SAU,77958223,94636700,103031365,112190977,21547390,29411929,32749848,35997107,574.7592339801088,1791.3328423864727
Philippines,Canada,118304,175504,236877,351848,454340,584697,633547,515243,4.355245807411415,118573,0.5005678052322513,179207,0.39443368402517937,48850,0.08354754684905173,PHL,CAN,77958223,94636700,103031365,112190977,30685730,34005902,35704498,38028638,564.7040581525554,1665.9734171915386
Nepal,Malaysia,14931,27097,48253,124125,276557,552855,585864,570933,38.23809523809524,33322,0.6905684620645348,309307,1.1184204341238877,33009,0.05970643297067043,NPL,MYS,24559500,27161567,27610325,29348627,22945150,28717731,31068833,33199993,1996.2228556722605,1764.650974474603
India,Australia,69928,78297,90680,148935,329510,449040,579264,509336,7.283720398123784,20752,0.22884869872077634,249754,0.7579557524809566,130224,0.2900053447354356,IND,AUS,1059633675,1240613620,1322866505,1396387127,19028802,22031750,23815995,25649248,41.483052142172895,2258.4053926259357
Philippines,United Arab Emirates,60107,91840,128860,202658,474083,518041,564769,504662,8.396060359026404,68753,0.5335480366288996,90686,0.19128717967107026,46728,0.09020135471902803,PHL,ARE,77958223,94636700,103031365,112190977,3275333,8481771,8916899,9287289,503.3996628801976,6081.09643190817
Pakistan,United Kingdom,228321,267177,310526,379494,460473,532502,537047,308726,1.3521577077885958,82205,0.26472823531684947,76574,0.1662942235483948,4545,0.008535179210594514,PAK,GBR,154369924,194454498,210969298,227196741,58892514,62766365,65116219,67081234,236.37971109805662,800.5920105763112
Sri Lanka,Saudi Arabia,200579,205566,211212,260909,338283,423765,529336,328757,1.639039979260042,10633,0.05034278355396474,191053,0.5647726903214173,105571,0.24912628461529385,LKA,SAU,18776371,20668557,21336697,21919000,21547390,29411929,32749848,35997107,2414.9641863223687,1470.495948466081
Nepal,Saudi Arabia,177661,182078,187079,231098,299632,403005,503404,325743,1.833508761067426,9418,0.05034236873192609,203772,0.6800742243819085,100399,0.24912594136549174,NPL,SAU,24559500,27161567,27610325,29348627,21547390,29411929,32749848,35997107,1715.2557085549522,1398.4568259888217
Afghanistan,Saudi Arabia,166255,170388,175068,216261,280395,385241,481215,314960,1.8944392649845117,8813,0.05034043914364704,200820,0.7162039266035415,95974,0.24912716974569166,AFG,SAU,19542982,28189672,33753499,38972230,21547390,29411929,32749848,35997107,1234.7638305531914,1336.8157613332648
South Korea,Japan,687832,660554,635194,532475,565989,457772,456203,-231629,-0.3367522883494807,-52638,-0.08286917067856435,-109786,-0.19397196765308158,-1569,-0.0034274704438017178,KOR,JPN,47008111,49554112,51014947,51836239,126843000,128070000,127141000,126261000,880.0850694434062,361.3174297684954
India,Nepal,369370,515578,543594,514650,461186,446113,426941,57571,0.15586268511248882,174224,0.3205039054882872,-34245,-0.07425420546157081,-19172,-0.0429756586335749,IND,NPL,1059633675,1240613620,1322866505,1396387127,24559500,27161567,27610325,29348627,30.57468747346881,1454.722226017592
China,Singapore,150447,191075,250198,299651,365797,419634,426434,275987,1.8344466822203167,99751,0.3986882389147795,60637,0.16576680508588096,6800,0.016204597339586402,CHN,SGP,1262645000,1337705000,1379860000,1411100000,4027887,5076732,5535002,5685807,30.21997023598611,7499.973178829319
Bangladesh,Malaysia,23930,33453,53272,202874,351422,392295,415717,391787,16.372210614291685,29342,0.550795915302598,64295,0.1829566731735634,23422,0.05970506888948368,BGD,MYS,129193327,148391139,157830000,167420951,22945150,28717731,31068833,33199993,248.30643806341774,1252.159902563835
Pakistan,United States of America,91889,159793,229151,261537,302798,376432,408412,316523,3.444623404324783,137262,0.5990024045280187,105614,0.3487935851623855,31980,0.0849555829472521,PAK,USA,154369924,194454498,210969298,227196741,282162411,309327143,320738994,331526933,179.76138134833545,123.19119786264845
Iran,United States of America,210941,250390,290417,314199,348249,394223,387246,176305,0.8358024281671178,79476,0.2736616658115744,38997,0.11198022104873237,-6977,-0.017698104879725434,IRN,USA,65544383,75373855,81790841,87290193,282162411,309327143,320738994,331526933,443.6305920414221,116.80679952479154
Bangladesh,Kuwait,126783,110044,136047,175042,258071,350229,380046,253263,1.9976100896807931,9264,0.06809411453394783,121975,0.47264124988859657,29817,0.08513572548247005,BGD,KWT,129193327,148391139,157830000,167420951,1934901,2943356,3908743,4360444,227.00026354527157,8715.763807538864
India,Bahrain,60505,74599,88904,157081,259915,281787,365098,304593,5.034178993471614,28399,0.3194344461441555,105183,0.4046822999826866,83311,0.295652389925724,IND,BHR,1059633675,1240613620,1322866505,1396387127,711442,1213645,1362142,1477469,26.1459013006212,24711.0430066553
Myanmar,Malaysia,4568,10170,19298,134525,226432,330851,350605,346037,75.75240805604203,14730,0.7632915328013266,124173,0.548389803561334,19754,0.05970663531317723,MMR,MYS,45538332,49390988,51483949,53423198,22945150,28717731,31068833,33199993,656.2785702196263,1056.0393792854113
Pakistan,Kuwait,129928,112925,139783,162388,225820,312434,339033,209105,1.6093913552121175,9855,0.07050213545280899,113213,0.501341776636259,26599,0.08513478046563434,PAK,KWT,154369924,194454498,210969298,227196741,1934901,2943356,3908743,4360444,149.22441163009466,7775.194452675002
Vietnam,Japan,6235,9224,16909,39408,41781,146956,335668,329433,52.83608660785886,10674,0.6312614583949376,293887,7.033986740384385,188712,1.284139470317646,VNM,JPN,79001142,87411012,92191398,96648685,126843000,128070000,127141000,126261000,347.30736377841043,265.85248017994473
Indonesia,United Arab Emirates,46598,68471,94285,121621,267618,292432,318809,272211,5.841688484484313,47687,0.5057750437503314,51191,0.19128384488337855,26377,0.09019874705914538,IDN,ARE,214072421,244016173,259091970,271857970,3275333,8481771,8916899,9287289,117.27042617143061,3432.745551473632
Bangladesh,Oman,50041,82653,92034,92947,108861,247568,316467,266426,5.32415419356128,41993,0.4562770280548493,207606,1.9070741587896491,68899,0.2783033348413365,BGD,OMN,129193327,148391139,157830000,167420951,2344253,2881914,4191776,4543399,189.02472964688872,6965.4239039978665
Vietnam,China,285788,289747,293705,300897,300897,300896,303095,17307,0.06055887581004101,7917,0.026955618733082515,2198,0.007304825239201455,2199,0.007308172923535042,VNM,CHN,79001142,87411012,92191398,96648685,1262645000,1337705000,1379860000,1411100000,313.60488764021983,21.479342357026432
China,"China, Macao SAR",172346,189060,204282,236962,251200,280130,300567,128221,0.7439743307068339,31936,0.15633291234665805,49367,0.19652468152866243,20437,0.07295541355799093,CHN,MAC,1262645000,1337705000,1379860000,1411100000,431896,557297,615239,676283,21.30019134008929,44443.96798381742
Philippines,Australia,90580,103492,112180,134557,183770,241130,286303,195723,2.1607750055199824,21600,0.19254769121055446,102533,0.5579419927082766,45173,0.1873387799112512,PHL,AUS,77958223,94636700,103031365,112190977,19028802,22031750,23815995,25649248,255.19253656200888,1116.22375829498
Philippines,Japan,49106,75318,144882,198241,210181,229595,275252,226146,4.605262086099458,95776,0.6610621057136152,65071,0.3095950633025821,45657,0.19885886016681548,PHL,JPN,77958223,94636700,103031365,112190977,126843000,128070000,127141000,126261000,245.34236830828206,218.0023918708073
Vietnam,Australia,136918,157398,163700,174411,203770,235590,269812,132894,0.9706101462189047,26782,0.1636041539401344,66042,0.3241007017716052,34222,0.14526083450061547,VNM,AUS,79001142,87411012,92191398,96648685,19028802,22031750,23815995,25649248,279.16779209153236,1051.9294756711774
Myanmar,Saudi Arabia,89529,101950,104750,129398,167772,214371,267776,178247,1.9909414826480805,15221,0.14530787589498806,100004,0.5960708580692845,53405,0.24912418190893357,MMR,SAU,45538332,49390988,51483949,53423198,21547390,29411929,32749848,35997107,501.23543708484095,743.8820014063907
Bangladesh,Qatar,36556,43199,43402,75689,169370,160183,261672,225116,6.158113579166211,6846,0.15773466660522556,92302,0.5449725453149908,101489,0.6335815910552306,BGD,QAT,129193327,148391139,157830000,167420951,645937,1713504,2414573,2760385,156.29585092967247,9479.547237070192
Bangladesh,United States of America,21414,59134,97713,126308,159527,222616,261496,240082,11.21145045297469,76299,0.7808479936139511,101969,0.639195872798962,38880,0.17465051927983613,BGD,USA,129193327,148391139,157830000,167420951,282162411,309327143,320738994,331526933,156.19072669106987,78.87624623245918
Thailand,United States of America,106919,140211,174112,195494,223435,267938,256642,149723,1.4003404446356589,67193,0.3859182595111193,33207,0.14862040414438205,-11296,-0.04215900693444006,THA,USA,63066603,68270489,70294397,71475664,282162411,309327143,320738994,331526933,359.0620718123024,77.41211179364423
Nepal,Qatar,459,498,464,23647,66011,151314,253940,253481,552.2461873638345,5,0.010775862068965518,187929,2.8469346018087895,102626,0.6782320208308551,NPL,QAT,24559500,27161567,27610325,29348627,645937,1713504,2414573,2760385,865.2534239506332,9199.44138227095
Afghanistan,Germany,33279,51537,69794,75824,80248,82361,250444,217165,6.52558670633132,36515,0.5231825085250881,170196,2.120875286611504,168083,2.0408081494882286,AFG,DEU,19542982,28189672,33753499,38972230,82211508,81776930,81686611,83160871,642.6216821567563,301.1560569152769
Pakistan,Oman,35675,59439,66498,70569,86029,195644,250092,214417,6.010287316047652,30823,0.46351769978044455,164063,1.9070662218554209,54448,0.2783014045920141,PAK,OMN,154369924,194454498,210969298,227196741,2344253,2881914,4191776,4543399,110.07728319483246,5504.513250982359
Bangladesh,United Kingdom,102380,124761,149241,169747,209581,215649,241799,139419,1.3617796444618089,46861,0.3139954838147694,32218,0.1537257671258368,26150,0.12126186534600207,BGD,GBR,129193327,148391139,157830000,167420951,58892514,62766365,65116219,67081234,144.4257714197311,360.4569945746675
Pakistan,Qatar,334,363,338,51773,145204,133212,235505,235171,704.1047904191616,4,0.011834319526627219,90301,0.6218905815266798,102293,0.7678962856199141,PAK,QAT,154369924,194454498,210969298,227196741,645937,1713504,2414573,2760385,103.65685659197023,8531.599758729308
China,Italy,32172,53519,74865,137633,194677,199617,233338,201166,6.252828546562228,42693,0.570266479663394,38661,0.1985904857790083,33721,0.16892849807381136,CHN,ITA,1262645000,1337705000,1379860000,1411100000,56942108,59277417,60730582,59438851,16.535893983417193,392.56815378211127
Hong Kong,United States of America,147131,177702,208749,216351,230796,248913,230584,83453,0.5672020172499337,61618,0.29517746192796135,-212,-9.185601136934783e-4,-18329,-0.0736361700674533,HKG,USA,6665000,7024200,7291300,7481000,282162411,309327143,320738994,331526933,3082.2617297152788,69.55211690146453
Hong Kong,Canada,230328,231291,237754,214333,205425,207658,225006,-5322,-0.023106179014275294,7426,0.031233964517947122,19581,0.09531945965680906,17348,0.08354120717718556,HKG,CAN,6665000,7024200,7291300,7481000,30685730,34005902,35704498,38028638,3007.6995054137146,591.6751475559025
Pakistan,Canada,24161,52674,82440,116119,136865,201014,217807,193646,8.014817267497206,58279,0.7069262493934984,80942,0.5914002849523253,16793,0.08354144487448635,PAK,CAN,154369924,194454498,210969298,227196741,30685730,34005902,35704498,38028638,95.86713217862575,572.7446773139759
Hong Kong,China,622,1011,1385,68509,156173,192643,209555,208933,335.90514469453376,763,0.5509025270758122,53382,0.3418132455674156,16912,0.08778933052329957,HKG,CHN,6665000,7024200,7291300,7481000,1262645000,1337705000,1379860000,1411100000,2801.1629461301964,14.850471263553258
China,United Kingdom,23384,83030,144073,146994,155196,199428,208229,184845,7.904763941156347,120689,0.8376933915445642,53033,0.3417162813474574,8801,0.044131215275688467,CHN,GBR,1262645000,1337705000,1379860000,1411100000,58892514,62766365,65116219,67081234,14.756502019700942,310.4131924585645
Malaysia,Bangladesh,92533,126263,159993,190436,204878,203561,199618,107085,1.157262814347314,67460,0.4216434469008019,-5260,-0.02567381563662277,-3943,-0.019370115100633224,MYS,BGD,22945150,28717731,31068833,33199993,129193327,148391139,157830000,167420951,601.2591629160886,119.2311946669088
Philippines,Kuwait,49207,45266,58906,76339,112977,181462,196910,147703,3.0016664295730284,9699,0.16465215767493974,83933,0.7429211255388265,15448,0.08513077118074308,PHL,KWT,77958223,94636700,103031365,112190977,1934901,2943356,3908743,4360444,175.51322331384992,4515.824535299616
Sri Lanka,India,281720,235785,189850,202417,212022,197564,184780,-96940,-0.3441005253443135,-91870,-0.4839083486963392,-27242,-0.128486666478007,-12784,-0.06470814520864125,LKA,IND,18776371,20668557,21336697,21919000,1059633675,1240613620,1322866505,1396387127,843.0129111729549,13.232720097970367
Vietnam,Canada,108997,127335,148701,151603,165125,168212,182265,73268,0.6722019872106572,39704,0.26700560184531374,17140,0.1038001514004542,14053,0.08354338572753431,VNM,CAN,79001142,87411012,92191398,96648685,30685730,34005902,35704498,38028638,188.5850800763611,479.2835336358878
China,Spain,8432,4349,2138,81322,154918,155713,179104,170672,20.240986717267553,-6294,-2.9438727782974743,24186,0.15612130288281542,23391,0.1502186715303154,CHN,ESP,1262645000,1337705000,1379860000,1411100000,40567864,46576897,46444832,47365655,12.692509389837715,378.130525166389
Malaysia,Australia,72135,80793,84650,101373,129880,143420,177286,105151,1.4576973729812157,12515,0.14784406379208506,47406,0.36499846011703113,33866,0.2361316413331474,MYS,AUS,22945150,28717731,31068833,33199993,19028802,22031750,23815995,25649248,533.9940884927295,691.1937535166724
Vietnam,South Korea,445,7664,17554,45497,91420,124852,177274,176829,397.3685393258427,17109,0.9746496525008546,85854,0.9391161671406695,52422,0.4198731297856662,VNM,KOR,79001142,87411012,92191398,96648685,47008111,49554112,51014947,51836239,183.42101602313573,341.9885458896816
Nepal,United States of America,2262,7081,12012,29611,48579,105677,176462,174200,77.01149425287356,9750,0.8116883116883117,127883,2.632474937730295,70785,0.6698240866035182,NPL,USA,24559500,27161567,27610325,29348627,282162411,309327143,320738994,331526933,601.26151727643,53.22704807213959
Laos,United States of America,171577,190445,209471,204193,205051,213777,173275,1698,0.0098964313398649,37894,0.18090332313303512,-31776,-0.15496632545074152,-40502,-0.1894591092587135,LAO,USA,5430853,6323418,6787419,7319399,282162411,309327143,320738994,331526933,2367.339176344943,52.26573854257567
Philippines,Qatar,37462,44332,44593,54268,107963,148496,170052,132590,3.5393198441086966,7131,0.15991299082815688,62089,0.5750951714939377,21556,0.1451621592500808,PHL,QAT,77958223,94636700,103031365,112190977,645937,1713504,2414573,2760385,151.57368671457422,6160.445010388044
India,Italy,3413,23261,43109,89745,128999,138591,167272,163859,48.01025490770583,39696,0.9208285972766708,38273,0.29669222242032883,28681,0.2069470600544047,IND,ITA,1059633675,1240613620,1322866505,1396387127,56942108,59277417,60730582,59438851,11.978913065416707,281.4186297107257
Iran,Canada,29467,51266,74284,95395,120685,153473,166294,136827,4.643397699121051,44817,0.6033196919928921,45609,0.3779177196834735,12821,0.08353912414561519,IRN,CAN,65544383,75373855,81790841,87290193,30685730,34005902,35704498,38028638,190.50708250811175,437.28623675662533
Indonesia,Singapore,21520,34241,50277,91090,136979,157139,159685,138165,6.420306691449814,28757,0.57197127911371,22706,0.1657626351484534,2546,0.016202215872571417,IDN,SGP,214072421,244016173,259091970,271857970,4027887,5076732,5535002,5685807,58.73839196253838,2808.484354111914
China,Bangladesh,140163,131427,122691,145405,160252,162772,159619,19456,0.1388098142876508,-17472,-0.14240653348656382,-633,-0.003950028704789956,-3153,-0.01937065342933674,CHN,BGD,1262645000,1337705000,1379860000,1411100000,129193327,148391139,157830000,167420951,11.311671745446814,95.3399195540348
Thailand,South Korea,43,1588,3640,12233,31372,77548,159264,159221,3702.813953488372,3597,0.9881868131868132,127892,4.076628841004718,81716,1.0537473564759892,THA,KOR,63066603,68270489,70294397,71475664,47008111,49554112,51014947,51836239,222.82269388920963,307.24451285904445
Myanmar,United States of America,19835,26561,33415,49239,66988,134424,156410,136575,6.885555835644063,13580,0.40640430944186745,89422,1.3348958022332358,21986,0.16355710289829198,MMR,USA,45538332,49390988,51483949,53423198,282162411,309327143,320738994,331526933,292.7754343721617,47.17867069943304
Cambodia,United States of America,118833,129616,140456,147478,159212,181502,154891,36058,0.30343423123206514,21623,0.15394856752292532,-4321,-0.027139914076828378,-26611,-0.1466154642924045,KHM,USA,12118841,14363532,15417523,16396860,282162411,309327143,320738994,331526933,944.638180724846,46.720487713738784
Sri Lanka,Qatar,932,1033,980,12231,33403,54731,154078,153146,164.3197424892704,48,0.04897959183673469,120675,3.612699458132503,99347,1.8151870055361679,LKA,QAT,18776371,20668557,21336697,21919000,645937,1713504,2414573,2760385,702.9426524932707,5581.757617143986
Iran,Germany,95723,100027,104331,108310,110767,113685,152590,56867,0.5940787480542816,8608,0.08250663752863482,41823,0.37757635396823963,38905,0.3422175308967762,IRN,DEU,65544383,75373855,81790841,87290193,82211508,81776930,81686611,83160871,174.8077243912154,183.48773667846743
Philippines,Italy,65197,75405,85612,114522,137814,142694,151520,86323,1.3240333144163074,20415,0.2384595617436808,13706,0.09945288577357889,8826,0.0618526357099808,PHL,ITA,77958223,94636700,103031365,112190977,56942108,59277417,60730582,59438851,135.0554242878195,254.9174444842482
Indonesia,Bangladesh,70627,84052,97476,123383,143647,152862,149901,79274,1.122431931131154,26849,0.2754421601214658,6254,0.04353728236579949,-2961,-0.019370412528947677,IDN,BGD,214072421,244016173,259091970,271857970,129193327,148391139,157830000,167420951,55.139453884688386,89.535389152102
India,Malaysia,20808,46325,87900,106098,119097,139752,148096,127288,6.117262591311034,67092,0.7632764505119454,28999,0.2434906000990789,8344,0.05970576449710917,IND,MYS,1059633675,1240613620,1322866505,1396387127,22945150,28717731,31068833,33199993,10.60565491735588,446.07238320803265
India,Singapore,14109,29739,48248,83963,124357,142659,144970,130861,9.275001771918634,34139,0.7075733709169292,20613,0.16575665221901462,2311,0.01619946866303563,IND,SGP,1059633675,1240613620,1322866505,1396387127,4027887,5076732,5535002,5685807,10.381791495847843,2549.6820416169594
South Korea,China,37449,50931,59108,85449,107940,133146,144831,107382,2.8674196907794602,21659,0.3664309399742844,36891,0.3417732073374097,11685,0.08776080392952097,KOR,CHN,47008111,49554112,51014947,51836239,1262645000,1337705000,1379860000,1411100000,279.4010576268853,10.263694989724328
China,New Zealand,9059,18991,37900,74705,84329,92602,144207,135148,14.91864444199139,28841,0.760976253298153,59878,0.7100522951772226,51605,0.5572773806181291,CHN,NZL,1262645000,1337705000,1379860000,1411100000,3857700,4350700,4609400,5090200,10.219474169087945,2833.0321008997685
Vietnam,France,99095,102298,105501,118704,118068,130958,143865,44770,0.451788687622988,6406,0.06071980360375731,25797,0.21849273300132127,12907,0.0985583164067869,VNM,FRA,79001142,87411012,92191398,96648685,60921384,65030575,66548272,67571107,148.8535513959657,212.90904705764257
China,Germany,19834,34512,49190,67622,82444,84616,142891,123057,6.204346072400928,29356,0.5967879650335434,60447,0.7331885886177284,58275,0.688699536730642,CHN,DEU,1262645000,1337705000,1379860000,1411100000,82211508,81776930,81686611,83160871,10.12621359223301,171.8247996705085
Afghanistan,United States of America,28444,37312,46342,51965,59330,74106,142504,114060,4.009984531008297,17898,0.38621552803072806,83174,1.4018877465026125,68398,0.9229751976897957,AFG,USA,19542982,28189672,33753499,38972230,282162411,309327143,320738994,331526933,365.65523707522,42.984139692807396
Sri Lanka,Canada,24410,56926,90795,107923,132130,131185,142144,117734,4.823187218353134,66385,0.7311525965086183,10014,0.07578899568606676,10959,0.08353851431184968,LKA,CAN,18776371,20668557,21336697,21919000,30685730,34005902,35704498,38028638,648.4967379898718,373.78146437955525
Philippines,United Kingdom,21328,29809,38793,78153,115812,130438,141722,120394,5.644879969992498,17465,0.45021008944912744,25910,0.22372465720305323,11284,0.08650853278952453,PHL,GBR,77958223,94636700,103031365,112190977,58892514,62766365,65116219,67081234,126.32210164280858,211.26922024123766
Indonesia,Hong Kong,90186,100652,111117,121316,131809,134708,140463,50277,0.5574812055086156,20931,0.18836901644212856,8654,0.06565560773543537,5755,0.042722035810790746,IDN,HKG,214072421,244016173,259091970,271857970,6665000,7024200,7291300,7481000,51.667788146876845,1877.596577997594
Sri Lanka,Australia,46660,52524,58210,70608,96480,119700,139456,92796,1.9887698242606087,11550,0.19841951554715684,42976,0.44543946932006634,19756,0.16504594820384294,LKA,AUS,18776371,20668557,21336697,21919000,19028802,22031750,23815995,25649248,636.2334048086136,543.7040493350917
Bangladesh,Italy,5421,14361,23300,60160,89149,105084,135468,130047,23.989485334809075,17879,0.7673390557939914,46319,0.5195683630775443,30384,0.289140116478246,BGD,ITA,129193327,148391139,157830000,167420951,56942108,59277417,60730582,59438851,80.91460428987767,227.9115388687443
South Korea,Canada,31722,56171,81955,102474,112400,122548,132786,101064,3.1859277473047096,50233,0.6129339271551462,20386,0.18137010676156584,10238,0.08354277507588863,KOR,CAN,47008111,49554112,51014947,51836239,30685730,34005902,35704498,38028638,256.1644181013981,349.1736937830905
Sri Lanka,United Kingdom,38424,51624,65693,90699,109679,141998,128207,89783,2.3366385592338124,27269,0.41509749897249326,18528,0.16892933013612452,-13791,-0.09712108621248186,LKA,GBR,18776371,20668557,21336697,21919000,58892514,62766365,65116219,67081234,584.9126328755874,191.12200589512113
Pakistan,Singapore,12345,26021,42217,73468,108812,124826,126848,114503,9.275253138922642,29872,0.7075822535945235,18036,0.1657537771569312,2022,0.016198548379344046,PAK,SGP,154369924,194454498,210969298,227196741,4027887,5076732,5535002,5685807,55.831786777258394,2230.9585956751607
China,France,41681,43028,44375,70951,103338,114531,125893,84212,2.020392984813224,2694,0.060709859154929574,22555,0.21826433644932164,11362,0.09920458216552723,CHN,FRA,1262645000,1337705000,1379860000,1411100000,60921384,65030575,66548272,67571107,8.921621430090001,186.31188031298643
Vietnam,Germany,69594,75465,81335,86970,90977,93372,125327,55733,0.8008305313676466,11741,0.14435359931148953,34350,0.377567956736318,31955,0.3422332176669665,VNM,DEU,79001142,87411012,92191398,96648685,82211508,81776930,81686611,83160871,129.6727420554144,150.70428976146727
Pakistan,Italy,6808,15787,24765,54772,78200,89137,124800,117992,17.331374853113985,17957,0.7250959014738543,46600,0.5959079283887468,35663,0.40009199322391376,PAK,ITA,154369924,194454498,210969298,227196741,56942108,59277417,60730582,59438851,54.930365396394485,209.96368183496682
Hong Kong,United Kingdom,72371,72931,74718,87020,91875,109963,124122,51751,0.7150792444487433,2347,0.03141144034904574,32247,0.35098775510204083,14159,0.1287614925020234,HKG,GBR,6665000,7024200,7291300,7481000,58892514,62766365,65116219,67081234,1659.1632134741344,185.03237432990574
South Korea,Australia,23735,28782,36180,51142,84150,106550,123396,99661,4.198904571308194,12445,0.3439745715865119,39246,0.4663814616755793,16846,0.15810417644298452,KOR,AUS,47008111,49554112,51014947,51836239,19028802,22031750,23815995,25649248,238.04967794827863,481.09012786651675
Philippines,Hong Kong,79010,88179,97347,106282,115475,118015,123056,44046,0.557473737501582,18337,0.18836738677103557,7581,0.06565057371725481,5041,0.042714909121721815,PHL,HKG,77958223,94636700,103031365,112190977,6665000,7024200,7291300,7481000,109.68440002086798,1644.9137815800027
India,New Zealand,9292,12459,20329,41448,56073,69800,122506,113214,12.184029272492467,11037,0.5429189827340253,66433,1.1847591532466606,52706,0.7551002865329512,IND,NZL,1059633675,1240613620,1322866505,1396387127,3857700,4350700,4609400,5090200,8.773068558945544,2406.7030764999413
Sri Lanka,United Arab Emirates,44420,43576,45340,49194,101145,110523,120491,76071,1.7125393966681675,920,0.020291133656815175,19346,0.19126995896979584,9968,0.0901893723478371,LKA,ARE,18776371,20668557,21336697,21919000,3275333,8481771,8916899,9287289,549.7102970026006,1297.3753697123025
Indonesia,Netherlands,186717,173584,166679,154880,140262,125118,118098,-68619,-0.36750269123861246,-20038,-0.12021910378631981,-22164,-0.15801856525644864,-7020,-0.05610703495899871,IDN,NLD,214072421,244016173,259091970,271857970,15925513,16615394,16939923,17441500,43.44106593601063,677.1091935900008
Philippines,Malaysia,104730,123116,176961,91270,38871,111343,117990,13260,0.1266112861644228,72231,0.4081746825571736,79119,2.0354248668673303,6647,0.059698409419541416,PHL,MYS,77958223,94636700,103031365,112190977,22945150,28717731,31068833,33199993,105.16888537301891,355.3916411970328
Afghanistan,Turkey,7652,9633,9020,9360,11074,94002,117595,109943,14.36787767903816,1368,0.1516629711751663,106521,9.61901751851183,23593,0.25098402161656136,AFG,TUR,19542982,28189672,33753499,38972230,64113547,73142150,78218479,83384680,301.74049573247413,141.02710473914394
Bangladesh,Bahrain,20442,24630,28889,49900,81920,88813,115071,94629,4.629145876137364,8447,0.29239502924988753,33151,0.40467529296875,26258,0.2956549153840091,BGD,BHR,129193327,148391139,157830000,167420951,711442,1213645,1362142,1477469,68.73154125136944,7788.386761414283
China,India,18165,98000,92343,96684,100003,110098,108008,89843,4.945939994494908,74178,0.8032877424385173,8005,0.08004759857204284,-2090,-0.018983087794510346,CHN,IND,1262645000,1337705000,1379860000,1411100000,1059633675,1240613620,1322866505,1396387127,7.654170505279568,7.73481779598216
Indonesia,Kuwait,38147,34017,43100,52868,75932,99485,107953,69806,1.8299210947125593,4953,0.11491879350348028,32021,0.4217062634989201,8468,0.08511835955169121,IDN,KWT,214072421,244016173,259091970,271857970,1934901,2943356,3908743,4360444,39.70933793112632,2475.734122488444
India,Germany,31877,32944,34011,45659,55002,56450,107628,75751,2.37635285629137,2134,0.06274440622151657,52626,0.956801570851969,51178,0.906607617360496,IND,DEU,1059633675,1240613620,1322866505,1396387127,82211508,81776930,81686611,83160871,7.7076047121136195,129.42144389036042
Hong Kong,Australia,57852,68683,75420,79837,85460,95050,107067,49215,0.8507052478738851,17568,0.23293556085918854,21607,0.25283173414462906,12017,0.1264281956864808,HKG,AUS,6665000,7024200,7291300,7481000,19028802,22031750,23815995,25649248,1431.1856703649244,417.42744270709227
Indonesia,United States of America,48387,61278,74394,83425,95254,104522,105617,57230,1.182755698844731,26007,0.349584643922897,10363,0.10879333151363722,1095,0.010476263370390922,IDN,USA,214072421,244016173,259091970,271857970,282162411,309327143,320738994,331526933,38.850065716300314,31.857743515517033
Pakistan,Bahrain,20949,25280,29683,46931,74535,80807,104698,83749,3.9977564561554253,8734,0.2942424957046121,30163,0.4046823639900718,23891,0.2956550793866868,PAK,BHR,154369924,194454498,210969298,227196741,711442,1213645,1362142,1477469,46.08252721371562,7086.30773302181
Pakistan,Afghanistan,8107,17225,26343,37163,47984,268369,102500,94393,11.643394597261626,18236,0.6922522112136051,54516,1.1361287095698567,-165869,-0.6180631891164777,PAK,AFG,154369924,194454498,210969298,227196741,19542982,28189672,33753499,38972230,45.11508375905797,263.00778785304306
Vietnam,Malaysia,12877,28668,54395,68238,78326,95517,101220,88343,6.860526520152209,41518,0.763268682783344,22894,0.2922911932180885,5703,0.059706649078174565,VNM,MYS,79001142,87411012,92191398,96648685,22945150,28717731,31068833,33199993,104.72982638097973,304.8795823541288
Sri Lanka,Italy,19974,30976,41977,63528,83767,84992,95811,75837,3.7967858215680383,22003,0.5241679967601306,12044,0.1437797700765218,10819,0.12729433358433734,LKA,ITA,18776371,20668557,21336697,21919000,56942108,59277417,60730582,59438851,437.1139194306309,161.1925506433494
Singapore,Malaysia,31269,33418,44779,59989,71367,87031,92227,60958,1.949470721801145,13510,0.30170392371424104,20860,0.2922919556657839,5196,0.0597028644965587,SGP,MYS,4027887,5076732,5535002,5685807,22945150,28717731,31068833,33199993,1622.056464456145,277.7922272453491
Indonesia,Australia,39102,45651,58650,60240,71170,77000,88852,49750,1.2723134366528566,19548,0.3332992327365729,17682,0.2484473795138401,11852,0.15392207792207793,IDN,AUS,214072421,244016173,259091970,271857970,19028802,22031750,23815995,25649248,32.68324265056493,346.4117154623793
Laos,Bangladesh,58722,59555,60387,71878,83217,88155,86447,27725,0.4721399134906849,1665,0.027572159570768542,3230,0.03881418460170398,-1708,-0.019374964551074812,LAO,BGD,5430853,6323418,6787419,7319399,129193327,148391139,157830000,167420951,1181.0669154666932,51.63451735499938
Pakistan,Malaysia,3208,4484,7140,16632,31814,80224,85013,81805,25.500311720698253,3932,0.5507002801120449,53199,1.672188344753882,4789,0.05969535301156761,PAK,MYS,154369924,194454498,210969298,227196741,22945150,28717731,31068833,33199993,37.41823039618337,256.0633070012997
Thailand,Germany,16629,26601,36573,50231,61212,62824,84324,67695,4.070900234530038,19944,0.5453203182675744,23112,0.377573024897079,21500,0.34222590092958105,THA,DEU,63066603,68270489,70294397,71475664,82211508,81776930,81686611,83160871,117.97581901442707,101.39864937201055
Iran,Turkey,23816,13188,13427,14451,14798,38569,84270,60454,2.5383775613033257,-10389,-0.7737394801519327,69472,4.6946884714150565,45701,1.184915346521818,IRN,TUR,65544383,75373855,81790841,87290193,64113547,73142150,78218479,83384680,96.54005461988153,101.06172980456363
Iran,United Kingdom,31563,36022,41087,58564,61831,74004,83531,51968,1.646484808161455,9524,0.2318008129091927,21700,0.35095663987320275,9527,0.1287362845251608,IRN,GBR,65544383,75373855,81790841,87290193,58892514,62766365,65116219,67081234,95.69345321529991,124.52215771701516
Pakistan,Australia,5949,8707,10950,16808,30600,62270,82497,76548,12.86737266767524,5001,0.4567123287671233,51897,1.6959803921568628,20227,0.3248273647021037,PAK,AUS,154369924,194454498,210969298,227196741,19028802,22031750,23815995,25649248,36.31082014508298,321.6351606097769
Thailand,Australia,15834,18920,23040,31545,51570,66400,82292,66458,4.197170645446508,7206,0.31276041666666665,30722,0.5957339538491371,15892,0.23933734939759035,THA,AUS,63066603,68270489,70294397,71475664,19028802,22031750,23815995,25649248,115.13289334394992,320.8359169048543
Fiji,Australia,37472,40344,46700,54761,63960,72600,80860,43388,1.1578778821520068,9228,0.1976017130620985,16900,0.26422764227642276,8260,0.1137741046831956,FJI,AUS,832509,905169,917200,920422,19028802,22031750,23815995,25649248,8785.100747265928,315.252907219736
Bangladesh,Singapore,8818,18587,30155,47991,68502,78584,79857,71039,8.056135178044908,21337,0.7075775161664732,11355,0.16576158360339843,1273,0.016199226305609285,BGD,SGP,129193327,148391139,157830000,167420951,4027887,5076732,5535002,5685807,47.69833137550389,1404.4971980230775
Nepal,Australia,404,1238,2000,3830,27200,50150,79427,79023,195.60148514851485,1596,0.798,52227,1.920110294117647,29277,0.5837886340977069,NPL,AUS,24559500,27161567,27610325,29348627,19028802,22031750,23815995,25649248,270.6327624798257,309.66599878483765
Iran,Sweden,40154,47650,51101,53882,59695,65462,79363,39209,0.9764656074114658,10947,0.21422281364356863,19668,0.3294748303878047,13901,0.21235220433228438,IRN,SWE,65544383,75373855,81790841,87290193,8872109,9378126,9799186,10353442,90.918575469297,766.5373505738479
Pakistan,Germany,26620,31202,35783,38473,40410,41474,79227,52607,1.976220886551465,9163,0.25607131878266215,38817,0.9605790645879733,37753,0.9102811399913199,PAK,DEU,154369924,194454498,210969298,227196741,82211508,81776930,81686611,83160871,34.87153893637937,95.26956493757743
Malaysia,United Kingdom,42754,45112,48230,55202,58281,69754,78736,35982,0.8416054638162511,5476,0.11353929089778146,20455,0.3509720148933615,8982,0.12876680907188118,MYS,GBR,22945150,28717731,31068833,33199993,58892514,62766365,65116219,67081234,237.1566765089378,117.37410793605855
China,Thailand,58,116,200,33311,68811,73828,77280,77222,1331.4137931034484,142,0.71,8469,0.12307625234337534,3452,0.04675732784309476,CHN,THA,1262645000,1337705000,1379860000,1411100000,63066603,68270489,70294397,71475664,5.476578555736659,108.12071644413126
China,Indonesia,258310,170906,83502,72094,65307,72302,76028,-182282,-0.7056714800046456,-174808,-2.093458839309238,10721,0.1641631065582556,3726,0.051533844153688696,CHN,IDN,1262645000,1337705000,1379860000,1411100000,214072421,244016173,259091970,271857970,5.387853447664942,27.96607360821535
Indonesia,Oman,4605,12728,17274,19887,25710,58468,74739,70134,15.229967426710097,12669,0.7334143799930531,49029,1.9070011668611435,16271,0.27828897858657725,IDN,OMN,214072421,244016173,259091970,271857970,2344253,2881914,4191776,4543399,27.4919289657022,1645.0019027604665
"China, Macao SAR",Hong Kong,57222,58769,60316,64994,69830,71366,74414,17192,0.30044388521897175,3094,0.05129650507328072,4584,0.06564513819275383,3048,0.04270941344617885,MAC,HKG,431896,557297,615239,676283,6665000,7024200,7291300,7481000,11003.381720374458,994.7065900280711
Iran,Australia,17599,19260,21360,26716,36480,61690,74322,56723,3.2230808568668676,3761,0.17607677902621724,37842,1.0373355263157895,12632,0.20476576430539795,IRN,AUS,65544383,75373855,81790841,87290193,19028802,22031750,23815995,25649248,85.14358537390335,289.7628811573735
Malaysia,United States of America,33834,42203,50714,55746,62621,71903,73947,40113,1.185582550097535,16880,0.332846945616595,11326,0.1808658437265454,2044,0.02842718662642727,MYS,USA,22945150,28717731,31068833,33199993,282162411,309327143,320738994,331526933,222.7319746724043,22.30497514360319
China,Netherlands,20779,26141,32395,43672,52617,61901,72803,52024,2.5036816016170174,11616,0.35857385398981323,20186,0.3836402683543341,10902,0.17611993344210916,CHN,NLD,1262645000,1337705000,1379860000,1411100000,15925513,16615394,16939923,17441500,5.159308341010559,417.412493191526
Cambodia,France,69234,71472,73710,58654,59482,65925,72465,3231,0.04666782216829881,4476,0.06072446072446072,12983,0.21826771124037525,6540,0.09920364050056883,KHM,FRA,12118841,14363532,15417523,16396860,60921384,65030575,66548272,67571107,441.9443722761553,107.24258224746859
Philippines,New Zealand,4379,6812,9860,14617,26902,38756,70412,66033,15.079470198675496,5481,0.5558823529411765,43510,1.617351869749461,31656,0.8168025596036743,PHL,NZL,77958223,94636700,103031365,112190977,3857700,4350700,4609400,5090200,62.760840383803775,1383.2855290558327
United States of America,South Korea,11713,16092,25592,33075,36756,54530,68050,56337,4.809784000683002,13879,0.5423179118474524,31294,0.8513984111437588,13520,0.24793691545938015,USA,KOR,282162411,309327143,320738994,331526933,47008111,49554112,51014947,51836239,20.526235797560375,131.27881442170215
Hong Kong,Singapore,15043,31708,51442,52509,56502,64817,65867,50824,3.3785813999867047,36399,0.7075735780101863,9365,0.16574634526211462,1050,0.016199453846984586,HKG,SGP,6665000,7024200,7291300,7481000,4027887,5076732,5535002,5685807,880.4571581339394,1158.4459338841434
Philippines,South Korea,482,7943,17932,22847,34918,51632,64942,64460,133.7344398340249,17450,0.9731206781173322,30024,0.8598430608855032,13310,0.2577858692283855,PHL,KOR,77958223,94636700,103031365,112190977,47008111,49554112,51014947,51836239,57.88522547584197,125.28300905472715
North Korea,Kazakhstan,19805,32525,45244,51580,57915,61600,64829,45024,2.273365311789952,25439,0.5622623994341791,6914,0.11938185271518605,3229,0.05241883116883117,PRK,KAZ,23367059,24686435,25258015,25867467,14883626,16321872,17542806,18755666,250.61982296140556,345.65021578012744
Fiji,New Zealand,16418,18262,25029,36097,45823,54815,64271,47853,2.9146668290900233,8611,0.3440409125414519,18448,0.40259258450996227,9456,0.17250752531241448,FJI,NZL,832509,905169,917200,920422,3857700,4350700,4609400,5090200,6982.775292202924,1262.6419394129896
Pakistan,Spain,2213,3186,5531,30659,56836,54547,63819,61606,27.838228648892905,3318,0.5998915205207015,6983,0.12286227039200506,9272,0.16998185051423542,PAK,ESP,154369924,194454498,210969298,227196741,40567864,46576897,46444832,47365655,28.089751516286057,134.73686788454629
Bangladesh,Canada,4203,13101,22310,33080,45325,58374,63250,59047,14.048774684748988,18107,0.8116091438816674,17925,0.3954771097628241,4876,0.08353033884948778,BGD,CAN,129193327,148391139,157830000,167420951,30685730,34005902,35704498,38028638,37.77902324781323,166.32202289232657
Philippines,Germany,22895,23278,23660,35620,45303,46497,62408,39513,1.7258353352260318,765,0.0323330515638208,17105,0.3775688144273006,15911,0.34219412005075595,PHL,DEU,77958223,94636700,103031365,112190977,82211508,81776930,81686611,83160871,55.62657681463992,75.04490904141684
Afghanistan,Australia,2729,7893,12580,18617,30840,49550,60879,58150,21.308171491388787,9851,0.7830683624801272,30039,0.9740272373540856,11329,0.2286377396569122,AFG,AUS,19542982,28189672,33753499,38972230,19028802,22031750,23815995,25649248,156.21123040688204,237.35198786334792
Philippines,Bahrain,7934,10206,12508,24672,42281,45839,59391,51457,6.4856314595412154,4574,0.36568596098496964,17110,0.4046734940043991,13552,0.2956434477191911,PHL,BHR,77958223,94636700,103031365,112190977,711442,1213645,1362142,1477469,52.93741224840212,4019.7797720290578
Brazil,China,3057,11819,23509,33986,42931,52956,57602,54545,17.8426561988878,20452,0.869964694372368,14671,0.34173441103165547,4646,0.08773321247828386,BRA,CHN,175873720,196353492,205188205,213196304,1262645000,1337705000,1379860000,1411100000,27.018292024424586,4.082063638296365
Indonesia,Japan,3624,7052,19347,23481,24895,35910,57169,53545,14.775110375275938,15723,0.8126841370755156,32274,1.2964049005824463,21259,0.5920077972709552,IDN,JPN,214072421,244016173,259091970,271857970,126843000,128070000,127141000,126261000,21.028995397854253,45.27843118619368
Myanmar,India,85706,73795,61884,63976,65575,61103,57149,-28557,-0.33319720906354283,-23822,-0.3849460280524853,-8426,-0.1284940907357987,-3954,-0.0647104070176587,MMR,IND,45538332,49390988,51483949,53423198,1059633675,1240613620,1322866505,1396387127,106.97412760651281,4.092632973692545
Philippines,China,7118,14556,23123,33428,42227,52087,56657,49539,6.959679685304861,16005,0.692167971284003,14430,0.3417244890709735,4570,0.08773782325724269,PHL,CHN,77958223,94636700,103031365,112190977,1262645000,1337705000,1379860000,1411100000,50.50049613169872,4.0150946070441496
China,Russian Federation,67405,64969,60177,58247,55119,56171,56138,-11267,-0.16715377197537273,-7228,-0.12011233527759775,1019,0.01848727299116457,-33,-5.874917662138826e-4,CHN,RUS,1262645000,1337705000,1379860000,1411100000,146596869,142849468,144640716,145245148,3.978314789880235,38.65051657353814
Afghanistan,Canada,5321,13677,22359,30718,40945,51641,55954,50633,9.51569253899643,17038,0.7620197683259538,15009,0.3665649041396996,4313,0.08351890939369881,AFG,CAN,19542982,28189672,33753499,38972230,30685730,34005902,35704498,38028638,143.574026941748,147.1364817220117
Uzbekistan,South Korea,30,1823,4198,9821,29405,43648,55601,55571,1852.3666666666666,4168,0.9928537398761315,26196,0.8908688998469648,11953,0.2738498900293255,UZB,KOR,24650400,28562400,31298900,34232050,47008111,49554112,51014947,51836239,162.4238104349579,107.26279736460046
India,France,25817,26652,27486,41118,45131,50020,54982,29165,1.1296819924855714,1669,0.060721822018482134,9851,0.21827568633533492,4962,0.09920031987205118,IND,FRA,1059633675,1240613620,1322866505,1396387127,60921384,65030575,66548272,67571107,3.9374467822632684,81.3690975937393
Sri Lanka,France,33041,34109,35177,34159,44946,49814,54756,21715,0.6572137647165642,2136,0.060721494158114675,9810,0.21826191429715658,4942,0.099209057694624,LKA,FRA,18776371,20668557,21336697,21919000,60921384,65030575,66548272,67571107,249.8106665450066,81.03463511408803
Cambodia,South Korea,3,20,44,4552,10863,41049,54573,54570,18190,41,0.9318181818181818,43710,4.023750345208506,13524,0.329459913761602,KHM,KOR,12118841,14363532,15417523,16396860,47008111,49554112,51014947,51836239,332.82591910890255,105.2796287940566
Iraq,Iran,290278,257645,204812,121384,99556,68735,54445,-235833,-0.8124384210997733,-85466,-0.41729000253891374,-45111,-0.45312186106312025,-14290,-0.20789990543391285,IRQ,IRN,24628858,31264875,37757813,42556984,65544383,75373855,81790841,87290193,127.93434797917071,62.37241335919603
Afghanistan,Sweden,3368,3997,4287,8255,12697,53678,53306,49938,14.827197149643705,919,0.21436902262654536,40609,3.1983145624950775,-372,-0.006930213495286709,AFG,SWE,19542982,28189672,33753499,38972230,8872109,9378126,9799186,10353442,136.77944526140794,514.8625935220383
Thailand,Japan,6726,16255,29291,38934,41279,45379,53087,46361,6.892804044008326,22565,0.7703731521627804,11808,0.28605344121708376,7708,0.16985830450208247,THA,JPN,63066603,68270489,70294397,71475664,126843000,128070000,127141000,126261000,74.27283221880947,42.04544554533862
Bangladesh,Australia,2315,5562,8490,16128,29550,43090,52907,50592,21.853995680345573,6175,0.7273262661955241,23357,0.7904230118443316,9817,0.22782548155024368,BGD,AUS,129193327,148391139,157830000,167420951,19028802,22031750,23815995,25649248,31.601182339479127,206.2711546163069
Malaysia,Brunei Darussalam,40306,42782,45258,46267,47276,48285,52628,12322,0.3057113084900511,4952,0.10941711962525963,5352,0.11320754716981132,4343,0.08994511753132443,MYS,BRN,22945150,28717731,31068833,33199993,333926,396053,421437,441725,158.5181057116488,11914.200011319259
Sri Lanka,Germany,38618,43756,48894,42932,37625,38616,51830,13212,0.34212025480345953,10276,0.21016893688387123,14205,0.3775415282392027,13214,0.342189765900145,LKA,DEU,18776371,20668557,21336697,21919000,82211508,81776930,81686611,83160871,236.46151740499113,62.32498454711952
Sri Lanka,United States of America,14022,19905,25904,33489,42299,52908,51543,37521,2.6758664955070603,11882,0.45869363804817787,9244,0.21853944537695927,-1365,-0.0257995010206396,LKA,USA,18776371,20668557,21336697,21919000,282162411,309327143,320738994,331526933,235.15215110178383,15.547153147886178
Fiji,United States of America,15935,23725,31674,35708,40945,46821,51535,35600,2.2340759334797617,15739,0.49690597966786637,10590,0.2586396385395042,4714,0.10068131821191345,FJI,USA,832509,905169,917200,920422,282162411,309327143,320738994,331526933,5599.062169309294,15.544740070937163
Afghanistan,United Kingdom,2076,8160,14382,36020,38029,45516,51376,49300,23.747591522157997,12306,0.8556528994576554,13347,0.3509689973441321,5860,0.12874593549521046,AFG,GBR,19542982,28189672,33753499,38972230,58892514,62766365,65116219,67081234,131.82720106085793,76.58773838298801
Philippines,Spain,8682,10514,16870,23923,38863,42659,51181,42499,4.895070260308684,8188,0.4853586247777119,12318,0.31695957594627283,8522,0.19977027122060995,PHL,ESP,77958223,94636700,103031365,112190977,40567864,46576897,46444832,47365655,45.61953320007188,108.05508759458726
Iran,Israel,47785,51220,51786,50950,50732,52322,50808,3023,0.06326253008266192,4001,0.07726026339165025,76,0.0014980682803753056,-1514,-0.028936202744543404,IRN,ISR,65544383,75373855,81790841,87290193,6289000,7623600,8380100,9215100,58.205851372100874,551.3559266855486
Vietnam,Czechia,3604,5386,7208,31521,52748,45525,50350,46746,12.970588235294118,3604,0.5,-2398,-0.045461439296276634,4825,0.10598572213069742,VNM,CZE,79001142,87411012,92191398,96648685,10255063,10474410,10546059,10697858,52.09589763171636,470.6549666297683
Indonesia,South Korea,65,8121,18763,18502,28486,42084,50117,50052,770.0307692307692,18698,0.9965357352235783,21631,0.759355472863863,8033,0.19088014447295884,IDN,KOR,214072421,244016173,259091970,271857970,47008111,49554112,51014947,51836239,18.43499383152166,96.68332611862523
Laos,France,50300,51926,53552,41673,40025,44359,48760,-1540,-0.03061630218687873,3252,0.060726023304451746,8735,0.21823860087445346,4401,0.0992132374489957,LAO,FRA,5430853,6323418,6787419,7319399,60921384,65030575,66548272,67571107,666.1749140878917,72.16101994599555
Afghanistan,Austria,4748,5357,5966,6614,10055,41725,47602,42854,9.0256950294861,1218,0.20415688903788132,37547,3.7341621084037793,5877,0.1408508088675854,AFG,AUT,19542982,28189672,33753499,38972230,8011566,8363404,8642699,8916864,122.14338260859078,533.8423912263324
India,Spain,4147,5084,8210,18346,35224,34447,47114,42967,10.360983843742465,4063,0.494884287454324,11890,0.33755394049511694,12667,0.36772433013034517,IND,ESP,1059633675,1240613620,1322866505,1396387127,40567864,46576897,46444832,47365655,3.3739927194272967,99.46869730820781
India,Bhutan,20841,24485,28128,35256,42383,44732,46974,26133,1.2539225564992083,7287,0.2590656996587031,4591,0.10832173277021448,2242,0.05012071894840383,IND,BTN,1059633675,1240613620,1322866505,1396387127,587207,705516,743274,772506,3.363966846423098,6080.729470062368
Philippines,Oman,5930,7180,6412,10324,15904,36168,46233,40303,6.7964586846543,482,0.0751715533374922,30329,1.9070045271629779,10065,0.2782846715328467,PHL,OMN,77958223,94636700,103031365,112190977,2344253,2881914,4191776,4543399,41.20919635096858,1017.5861728190722
Uganda,India,2058,1465,872,29845,51990,48444,45309,43251,21.016034985422742,-1186,-1.360091743119266,-6681,-0.12850548182342758,-3135,-0.06471389645776567,UGA,IND,24020697,32341728,37477356,44404611,1059633675,1240613620,1322866505,1396387127,102.03670064804756,3.2447305710517336
Afghanistan,Greece,621,472,331,3401,6704,5810,45293,44672,71.93558776167473,-290,-0.8761329305135952,38589,5.756115751789976,39483,6.795697074010327,AFG,GRC,19542982,28189672,33753499,38972230,10805808,11121341,10820883,10698599,116.21865107539394,423.35449716360057
United States of America,Bangladesh,28559,30085,31610,37560,43455,46008,45115,16556,0.5797121747960363,3051,0.09652008857956343,1660,0.038200437233920144,-893,-0.019409667883846286,USA,BGD,282162411,309327143,320738994,331526933,129193327,148391139,157830000,167420951,13.608245819352481,26.94704559407263
Indonesia,Qatar,108178,130606,133562,64612,48072,43049,43839,-64339,-0.5947512433211929,25384,0.19005405729174465,-4233,-0.08805541687468797,790,0.018351181212107135,IDN,QAT,214072421,244016173,259091970,271857970,645937,1713504,2414573,2760385,16.125699754176786,1588.148030075515
Thailand,Sweden,8135,9653,10353,18080,28604,36472,43476,35341,4.344314689612784,2218,0.21423741910557326,14872,0.5199272828974969,7004,0.19203772757183593,THA,SWE,63066603,68270489,70294397,71475664,8872109,9378126,9799186,10353442,60.82629746538626,419.9183228147702
India,Netherlands,7540,8940,10649,11962,17273,24060,42285,34745,4.608090185676392,3109,0.2919522959902338,25012,1.4480402941006194,18225,0.7574812967581047,IND,NLD,1059633675,1240613620,1322866505,1396387127,15925513,16615394,16939923,17441500,3.02817171416104,242.43901040621506
Nepal,South Korea,10,956,2208,4499,8569,29131,40748,40738,4073.8,2198,0.9954710144927537,32179,3.7552806628544753,11617,0.3987847996979163,NPL,KOR,24559500,27161567,27610325,29348627,47008111,49554112,51014947,51836239,138.8412480079562,78.60909816393122
Bangladesh,Maldives,1623,3574,5286,20163,28598,37034,40390,38767,23.886013555144793,3663,0.6929625425652668,11792,0.41233652702986223,3356,0.09061943079332506,BGD,MDV,129193327,148391139,157830000,167420951,282507,361575,435582,514438,24.12481816567868,7851.2862580136
Sri Lanka,Kuwait,36364,23883,20680,20377,25192,36556,39667,3303,0.09083159168408315,-15684,-0.7584139264990328,14475,0.574587170530327,3111,0.08510230878651931,LKA,KWT,18776371,20668557,21336697,21919000,1934901,2943356,3908743,4360444,180.97084721018297,909.700938711746
Thailand,United Kingdom,7189,11357,15716,27756,29304,35073,39589,32400,4.506885519543747,8527,0.542568083481802,10285,0.35097597597597596,4516,0.1287600148262196,THA,GBR,63066603,68270489,70294397,71475664,58892514,62766365,65116219,67081234,55.38808285852371,59.016505271802245
Vietnam,Cambodia,16771,44367,71963,56174,40384,36436,39098,22327,1.3312861487090812,55192,0.7669496824757167,-1286,-0.03184429477020602,2662,0.073059611373367,VNM,KHM,79001142,87411012,92191398,96648685,12118841,14363532,15417523,16396860,40.45373198817966,238.4480931105102
Cambodia,Australia,20651,23310,24970,27606,31720,34420,38969,18318,0.8870272626022953,4319,0.17296756107328795,7249,0.22853089533417403,4549,0.1321615339918652,KHM,AUS,12118841,14363532,15417523,16396860,19028802,22031750,23815995,25649248,237.6613571134961,151.93038018112657
United Arab Emirates,India,9940,12301,14662,31371,44142,41132,38470,28530,2.870221327967807,4722,0.3220570181421361,-5672,-0.12849440442209234,-2662,-0.06471846737333463,ARE,IND,3275333,8481771,8916899,9287289,1059633675,1240613620,1322866505,1396387127,414.22206200323905,2.754966674796623
Nepal,Bangladesh,9670,11361,13051,24995,33308,39059,38301,28631,2.9608066184074455,3381,0.25906060838249945,4993,0.14990392698450822,-758,-0.0194065388258788,NPL,BGD,24559500,27161567,27610325,29348627,129193327,148391139,157830000,167420951,130.5035496209073,22.87706512908292
China,Philippines,53792,72391,88418,71566,35398,35952,38269,-15523,-0.28857450922070194,34626,0.3916170915424461,2871,0.08110627719080174,2317,0.06444704049844237,CHN,PHL,1262645000,1337705000,1379860000,1411100000,77958223,94636700,103031365,112190977,2.7119977322656084,34.110586272904996
Myanmar,Australia,9884,11346,12100,13328,23260,32160,38215,28331,2.866349656009713,2216,0.1831404958677686,14955,0.6429492691315564,6055,0.18827736318407962,MMR,AUS,45538332,49390988,51483949,53423198,19028802,22031750,23815995,25649248,71.53259525946014,148.99072284692323
United States of America,Philippines,17746,23882,35977,29119,35015,35564,37857,20111,1.1332694691761525,18231,0.5067404174889513,2842,0.08116521490789662,2293,0.06447531211337307,USA,PHL,282162411,309327143,320738994,331526933,77958223,94636700,103031365,112190977,11.418981757358459,33.74335531457223
Nepal,United Kingdom,828,3257,5741,26091,27546,32969,37212,36384,43.94202898550725,4913,0.8557742553562098,9666,0.35090394249618817,4243,0.12869665443295217,NPL,GBR,24559500,27161567,27610325,29348627,58892514,62766365,65116219,67081234,126.7929842169448,55.47304034389111
Afghanistan,Netherlands,9865,14531,19683,32187,30985,32735,36418,26553,2.691637100861632,9818,0.4988060763095057,5433,0.1753429078586413,3683,0.11250954635711012,AFG,NLD,19542982,28189672,33753499,38972230,15925513,16615394,16939923,17441500,93.4460255417768,208.80084855087006
India,Sweden,8730,10359,11110,13447,16395,20976,36133,27403,3.138946162657503,2380,0.21422142214221424,19738,1.2039036291552303,15157,0.7225877192982456,IND,SWE,1059633675,1240613620,1322866505,1396387127,8872109,9378126,9799186,10353442,2.587606209005105,348.99504918267763
India,Japan,3108,5584,10065,21219,22497,26244,35936,32828,10.562419562419562,6957,0.6912071535022355,13439,0.5973685380272925,9692,0.36930345983843926,IND,JPN,1059633675,1240613620,1322866505,1396387127,126843000,128070000,127141000,126261000,2.573498373420625,28.46167858642019
Sri Lanka,Switzerland,18837,20205,21648,28472,28566,30931,35755,16918,0.8981260285608111,2811,0.12985033259423504,7189,0.25166281593502765,4824,0.15596004008923087,LKA,CHE,18776371,20668557,21336697,21919000,7184250,7824909,8282396,8638167,163.1233176696017,413.91883254861824
Afghanistan,France,3346,3455,3563,3409,4470,6510,35348,32002,9.564255827854154,217,0.060903732809430254,30878,6.907829977628635,28838,4.429800307219662,AFG,FRA,19542982,28189672,33753499,38972230,60921384,65030575,66548272,67571107,90.70048082955479,52.31229969341778
Vietnam,United Kingdom,19674,20943,22566,24657,26032,31158,35168,15494,0.7875368506658534,2892,0.12815740494549321,9136,0.35095267363245236,4010,0.1286988895307786,VNM,GBR,79001142,87411012,92191398,96648685,58892514,62766365,65116219,67081234,36.387458349795445,52.425988466461426
China,Myanmar,72413,55637,44999,38118,35082,33656,35104,-37309,-0.5152251667518263,-27414,-0.609213538078624,22,6.271022176614788e-4,1448,0.043023532208224385,CHN,MMR,1262645000,1337705000,1379860000,1411100000,45538332,49390988,51483949,53423198,2.487704627595493,65.70928232338319
Iran,Netherlands,5187,12357,19921,23906,25349,28885,34809,29622,5.7108155002891845,14734,0.7396215049445309,9460,0.37319026391573634,5924,0.2050891466158906,IRN,NLD,65544383,75373855,81790841,87290193,15925513,16615394,16939923,17441500,39.87733192433198,199.57572456497437
China,Sweden,6920,8212,8150,13134,21706,28014,34767,27847,4.024132947976879,1230,0.150920245398773,13061,0.6017230258914585,6753,0.24105804240736775,CHN,SWE,1262645000,1337705000,1379860000,1411100000,8872109,9378126,9799186,10353442,2.4638225497838566,335.8013692451264
India,Bangladesh,13339,18075,22811,27687,32301,34431,33762,20423,1.5310742934252943,9472,0.41523826224190086,1461,0.045230797808117396,-669,-0.019430164677180447,IND,BGD,1059633675,1240613620,1322866505,1396387127,129193327,148391139,157830000,167420951,2.417810888341138,20.165934907393996
South Korea,Kazakhstan,41045,32244,23442,26725,30007,31916,33588,-7457,-0.18167864538920697,-17603,-0.7509171572391434,3581,0.11933882094178025,1672,0.05238751723273593,KOR,KAZ,47008111,49554112,51014947,51836239,14883626,16321872,17542806,18755666,64.79636765313934,179.08188384246125
South Korea,Indonesia,10866,7189,3513,15679,28850,31940,33580,22714,2.090373642554758,-7353,-2.093082835183604,4730,0.16395147313691508,1640,0.05134627426424546,KOR,IDN,47008111,49554112,51014947,51836239,214072421,244016173,259091970,271857970,64.78093443469153,12.352038088123736
Indonesia,Bahrain,6151,7640,9152,14859,23845,25851,33493,27342,4.445130873028776,3001,0.32790646853146854,9648,0.404613126441602,7642,0.29561719082433946,IDN,BHR,214072421,244016173,259091970,271857970,711442,1213645,1362142,1477469,12.320036083547595,2266.917275421684
Thailand,Cambodia,14149,37488,60844,47494,34143,30806,33048,18899,1.335712771220581,46695,0.767454473736112,-1095,-0.0320709955188472,2242,0.07277803025384666,THA,KHM,63066603,68270489,70294397,71475664,12118841,14363532,15417523,16396860,46.23671631787849,201.55078472341654
United Kingdom,Indonesia,20883,13817,6751,16969,28276,31304,32911,12028,0.5759708854091845,-14132,-2.093319508221004,4635,0.1639199320978922,1607,0.051335292614362385,GBR,IDN,58892514,62766365,65116219,67081234,214072421,244016173,259091970,271857970,49.06141112430937,12.105953708107215
United States of America,India,5649,4490,3330,22818,37713,35141,32867,27218,4.818197911134714,-2319,-0.6963963963963964,-4846,-0.12849680481531567,-2274,-0.06471073674625082,USA,IND,282162411,309327143,320738994,331526933,1059633675,1240613620,1322866505,1396387127,9.913825010410239,2.3537169144928676
Sri Lanka,South Korea,60,1258,2858,7941,16165,20085,32841,32781,546.35,2798,0.9790062981105668,16676,1.03161150634086,12756,0.6351008215085885,LKA,KOR,18776371,20668557,21336697,21919000,47008111,49554112,51014947,51836239,149.82891555271684,63.35529088057488
United Kingdom,Bangladesh,9090,16056,23021,27337,31619,33470,32820,23730,2.6105610561056105,13931,0.6051431301854828,1201,0.03798349093899238,-650,-0.019420376456528235,GBR,BGD,58892514,62766365,65116219,67081234,129193327,148391139,157830000,167420951,48.92575470510874,19.603281312145935
South Korea,New Zealand,783,11855,17448,27550,27818,27640,32519,31736,40.53128991060026,16665,0.9551237964236589,4701,0.16899130059673592,4879,0.17651953690303906,KOR,NZL,47008111,49554112,51014947,51836239,3857700,4350700,4609400,5090200,62.73410383805044,638.8550548112058
South Korea,Germany,20119,20781,21442,22655,23486,24105,32352,12233,0.6080322083602565,1323,0.061701333830799364,8866,0.37750149024951035,8247,0.34212818917237087,KOR,DEU,47008111,49554112,51014947,51836239,82211508,81776930,81686611,83160871,62.41193540295236,38.90291144257015
China,Peru,2548,2551,2981,3502,6491,18783,31931,29383,11.531789638932496,433,0.14525327071452532,25440,3.919272839315976,13148,0.6999946760368418,CHN,PER,1262645000,1337705000,1379860000,1411100000,26654439,29229572,30711863,33304756,2.262844589327475,95.87519572279707
Mongolia,South Korea,112,703,1519,9094,20266,24452,31107,30995,276.74107142857144,1407,0.9262672811059908,10841,0.5349353597157801,6655,0.272165876001963,MNG,KOR,2450979,2702520,2964749,3294335,47008111,49554112,51014947,51836239,944.2573387345245,60.01014078201159
Philippines,Guam,24527,28576,32625,30827,29028,29289,30994,6467,0.2636686101031516,8098,0.24821455938697318,1966,0.06772771117541684,1705,0.05821298098262146,PHL,GUM,77958223,94636700,103031365,112190977,160188,164905,167978,169231,27.62610757904354,18314.61138916629
Indonesia,China,5386,8996,12575,18179,22963,28325,30811,25425,4.720571852952098,7189,0.5716898608349901,7848,0.34176719069807954,2486,0.08776699029126214,IDN,CHN,214072421,244016173,259091970,271857970,1262645000,1337705000,1379860000,1411100000,11.333491528683158,2.183473885621147
Philippines,"China, Macao SAR",1891,2074,5239,6077,14193,28124,30173,28282,14.956107879428874,3348,0.6390532544378699,15980,1.1259071373212146,2049,0.07285592376617836,PHL,MAC,77958223,94636700,103031365,112190977,431896,557297,615239,676283,26.894319674210518,4461.593741081766
Sri Lanka,Oman,13996,14591,11085,9913,10342,23519,30063,16067,1.1479708488139468,-2911,-0.26260712674785747,19721,1.906884548443241,6544,0.27824312258174244,LKA,OMN,18776371,20668557,21336697,21919000,2344253,2881914,4191776,4543399,137.15497969797892,661.6852272934867
India,South Africa,8356,10958,16920,22261,34871,34606,29935,21579,2.582455720440402,8564,0.5061465721040189,-4936,-0.14155028533738637,-4671,-0.1349765936542796,IND,ZAF,1059633675,1240613620,1322866505,1396387127,46813266,51784921,55876504,58801927,2.1437464884335045,50.90819557665177
Bahrain,Bangladesh,89,10375,20661,24592,28471,30160,29574,29485,331.29213483146066,20572,0.9956923672619912,1103,0.038741175230936745,-586,-0.019429708222811672,BHR,BGD,711442,1213645,1362142,1477469,129193327,148391139,157830000,167420951,2001.6663632198038,17.664455866100056
China,North Korea,19668,19590,19511,22740,25969,28594,29248,9580,0.4870856213138092,-157,-0.00804674286300036,3279,0.1262659324579306,654,0.022871931174372247,CHN,PRK,1262645000,1337705000,1379860000,1411100000,23367059,24686435,25258015,25867467,2.072709233930976,113.06866652231547
Nepal,United Arab Emirates,1730,2217,2832,8818,23410,25580,27886,26156,15.11907514450867,1102,0.3891242937853107,4476,0.1912003417343016,2306,0.09014855355746677,NPL,ARE,24559500,27161567,27610325,29348627,3275333,8481771,8916899,9287289,95.0163699310363,300.2598497796289
Bhutan,Nepal,16805,107664,111196,108387,75457,28740,27502,10697,0.6365367450163641,94391,0.8488704629662938,-47955,-0.6355275189843222,-1238,-0.043075852470424496,BTN,NPL,587207,705516,743274,772506,24559500,27161567,27610325,29348627,3560.101798562083,93.7079611935509
India,Myanmar,41093,37969,35038,29680,27316,26205,27325,-13768,-0.3350448981578371,-6055,-0.1728123751355671,9,3.2947722946258603e-4,1120,0.04273993512688418,IND,MMR,1059633675,1240613620,1322866505,1396387127,45538332,49390988,51483949,53423198,1.9568355702837985,51.14819221417632
Pakistan,France,15579,16083,16586,16544,22329,24748,27203,11624,0.7461326144168432,1007,0.060713855058483056,4874,0.21828115903085674,2455,0.09919993534831098,PAK,FRA,154369924,194454498,210969298,227196741,60921384,65030575,66548272,67571107,11.973323156074674,40.25833112368575
Vietnam,Bangladesh,40088,29184,18280,22153,25830,27521,26986,-13102,-0.3268309718619038,-21808,-1.1929978118161926,1156,0.04475416182733256,-535,-0.01943970059227499,VNM,BGD,79001142,87411012,92191398,96648685,129193327,148391139,157830000,167420951,27.921745650238282,16.118651721193483
Myanmar,South Korea,88,552,1193,1978,3544,18128,26922,26834,304.9318181818182,1105,0.9262363788767812,23378,6.596501128668171,8794,0.48510591350397175,MMR,KOR,45538332,49390988,51483949,53423198,47008111,49554112,51014947,51836239,50.39383827228015,51.93663838149986
Fiji,Canada,15352,18730,22553,22701,24290,24513,26559,11207,0.7300026055237102,7201,0.3192923336141533,2269,0.09341292713050638,2046,0.0834659160445478,FJI,CAN,832509,905169,917200,920422,30685730,34005902,35704498,38028638,2885.524248659854,69.83947203157788
Iran,France,23359,24114,24869,20643,21399,23716,26069,2710,0.11601524037844085,1510,0.06071816317503719,4670,0.2182344969391093,2353,0.09921571934558948,IRN,FRA,65544383,75373855,81790841,87290193,60921384,65030575,66548272,67571107,29.864752389767315,38.580099035524164
India,Belgium,5343,6415,7298,10615,15220,19815,25900,20557,3.8474639715515626,1955,0.2678816114003837,10680,0.7017082785808147,6085,0.30709058793843047,IND,BEL,1059633675,1240613620,1322866505,1396387127,10251250,10895586,11274196,11538604,1.8547865057767752,224.46389528577288
Sri Lanka,Japan,1206,2832,5655,8580,9097,13152,25781,24575,20.377280265339966,4449,0.786737400530504,16684,1.8340112124876333,12629,0.9602341849148418,LKA,JPN,18776371,20668557,21336697,21919000,126843000,128070000,127141000,126261000,117.61941694420365,20.41881499433713
Malaysia,Canada,15453,18151,21280,21513,22365,23644,25618,10165,0.6578010742250696,5827,0.27382518796992483,3253,0.14545048066174826,1974,0.0834884114363052,MYS,CAN,22945150,28717731,31068833,33199993,30685730,34005902,35704498,38028638,77.16266687164664,67.36502106649205
Cambodia,Canada,17233,17797,18784,20565,23755,23177,25111,7878,0.45714617304009747,1551,0.08257027257240204,1356,0.05708271942748895,1934,0.08344479440824956,KHM,CAN,12118841,14363532,15417523,16396860,30685730,34005902,35704498,38028638,153.14517535674514,66.03181528615355
China,Switzerland,8082,9792,11538,13467,15226,20556,25088,17006,2.1041821331353625,3456,0.2995319812792512,9862,0.6477078681203206,4532,0.2204709087371084,CHN,CHE,1262645000,1337705000,1379860000,1411100000,7184250,7824909,8282396,8638167,1.777903763021756,290.4319863230243
Afghanistan,Belgium,93,79,60,2479,4242,12819,24670,24577,264.26881720430106,-33,-0.55,20428,4.815652993870816,11851,0.9244870894765582,AFG,BEL,19542982,28189672,33753499,38972230,10251250,10895586,11274196,11538604,63.301484159361685,213.80402689961457
China,Brazil,8532,9429,10326,14884,19232,22671,24632,16100,1.8870135958743555,1794,0.1737361998837885,5400,0.28078202995008317,1961,0.08649816946760178,CHN,BRA,1262645000,1337705000,1379860000,1411100000,175873720,196353492,205188205,213196304,1.7455885479413225,11.553671211861158
Nepal,Kuwait,1416,1134,1294,1398,1854,22678,24607,23191,16.377824858757062,-122,-0.09428129829984544,22753,12.272384034519957,1929,0.0850604109709851,NPL,KWT,24559500,27161567,27610325,29348627,1934901,2943356,3908743,4360444,83.84378594610236,564.3232661628036
Philippines,Norway,3552,4686,5698,7939,13124,20512,24388,20836,5.865990990990991,2146,0.37662337662337664,11264,0.8582749161840902,3876,0.1889625585023401,PHL,NOR,77958223,94636700,103031365,112190977,4490967,4889252,5188607,5379475,21.737933523834094,453.35279000274187
Iran,Austria,8535,9629,10723,11889,13205,15582,24092,15557,1.822729935559461,2188,0.20404737480182786,10887,0.8244604316546763,8510,0.5461429854960852,IRN,AUT,65544383,75373855,81790841,87290193,8011566,8363404,8642699,8916864,27.599893151799996,270.1846747914962
Singapore,Indonesia,4346,2875,1405,10537,20346,22525,23681,19335,4.4489185457892315,-2941,-2.093238434163701,3335,0.16391428290573085,1156,0.05132075471698113,SGP,IDN,4027887,5076732,5535002,5685807,214072421,244016173,259091970,271857970,416.4932084398925,8.710798509971953
South Korea,France,18230,18820,19409,17773,19439,21545,23681,5451,0.29901261656609984,1179,0.060745015199134424,4242,0.2182211019085344,2136,0.09914133209561383,KOR,FRA,47008111,49554112,51014947,51836239,60921384,65030575,66548272,67571107,45.68425575782996,35.046044162041035
Thailand,Indonesia,1458,964,471,10085,20346,22525,23681,22223,15.242112482853223,-987,-2.0955414012738856,3335,0.16391428290573085,1156,0.05132075471698113,THA,IDN,63066603,68270489,70294397,71475664,214072421,244016173,259091970,271857970,33.13155649732754,8.710798509971953
Timor-Leste,Indonesia,729,71378,142028,78666,20346,22525,23681,22952,31.484224965706446,141299,0.9948672092826767,3335,0.16391428290573085,1156,0.05132075471698113,TLS,IDN,878360,1088486,1205813,1299995,214072421,244016173,259091970,271857970,1821.6223908553493,8.710798509971953
Brunei Darussalam,India,16220,23639,31057,28757,27000,25158,23530,7310,0.45067817509247843,14837,0.47773448819911773,-3470,-0.12851851851851853,-1628,-0.06471102631369743,BRN,IND,333926,396053,421437,441725,1059633675,1240613620,1322866505,1396387127,5326.843624426962,1.68506279849141
India,Ireland,750,2655,6019,13821,19348,19764,22662,21912,29.216,5269,0.8753945838179099,3314,0.171283853628282,2898,0.14663023679417123,IND,IRL,1059633675,1240613620,1322866505,1396387127,3805174,4560155,4701957,4985382,1.6229023858653775,454.5689778636823
India,Switzerland,7360,9984,12645,14300,16687,19336,22641,15281,2.0762228260869566,5285,0.4179517595887703,5954,0.3568046982681129,3305,0.1709247000413736,IND,CHE,1059633675,1240613620,1322866505,1396387127,7184250,7824909,8282396,8638167,1.6213985049147477,262.10421724886777
Hong Kong,"China, Macao SAR",11736,12873,14240,16517,18888,20984,22512,10776,0.918200408997955,2504,0.17584269662921348,3624,0.19186785260482847,1528,0.07281738467403737,HKG,MAC,6665000,7024200,7291300,7481000,431896,557297,615239,676283,300.92233658601793,3328.7839558291425
Japan,South Korea,4447,8709,15744,14133,18100,17632,22466,18019,4.051945131549359,11297,0.7175431910569106,4366,0.24121546961325968,4834,0.2741606170598911,JPN,KOR,126843000,128070000,127141000,126261000,47008111,49554112,51014947,51836239,17.79330117771917,43.34033570606849
China,Panama,10235,10439,11300,12365,15942,18665,22427,12192,1.1912066438690767,1065,0.09424778761061947,6485,0.40678710324927864,3762,0.20155371015269222,CHN,PAN,1262645000,1337705000,1379860000,1411100000,3001731,3623617,3957099,4294396,1.5893274750194883,522.2387502223829
Thailand,Norway,1291,2238,3584,7206,13026,18017,22304,21013,16.276529821843532,2293,0.6397879464285714,9278,0.7122677721480116,4287,0.23794194371982016,THA,NOR,63066603,68270489,70294397,71475664,4490967,4889252,5188607,5379475,31.205026650749268,414.61295014848105
Indonesia,Germany,8819,9827,10834,13611,15818,16234,21787,12968,1.4704615035718336,2015,0.1859885545504892,5969,0.3773549121254267,5553,0.34205987433780954,IDN,DEU,214072421,244016173,259091970,271857970,82211508,81776930,81686611,83160871,8.014111191958065,26.19861930017544
China,Belgium,4851,5889,6757,12247,15591,19048,21418,16567,3.4151721294578437,1906,0.2820778451975729,5827,0.373741260983901,2370,0.12442251154976901,CHN,BEL,1262645000,1337705000,1379860000,1411100000,10251250,10895586,11274196,11538604,1.517822974984055,185.62037487377157
Malaysia,New Zealand,8661,11569,11151,13911,15575,16991,21317,12656,1.4612631335873456,2490,0.22329835889157923,5742,0.3686677367576244,4326,0.2546053793184627,MYS,NZL,22945150,28717731,31068833,33199993,3857700,4350700,4609400,5090200,64.20784486309982,418.78511649836946
Pakistan,Norway,10470,11567,13283,15081,17152,19283,21140,10670,1.0191021967526266,2813,0.21177444854325078,3988,0.23250932835820895,1857,0.09630244256599077,PAK,NOR,154369924,194454498,210969298,227196741,4490967,4889252,5188607,5379475,9.304710933331565,392.9751509208612
Mongolia,Russian Federation,21142,22734,23503,22355,20748,21144,21132,-10,-4.729921483303377e-4,2361,0.10045526103050674,384,0.01850780798149219,-12,-5.675368898978433e-4,MNG,RUS,2450979,2702520,2964749,3294335,146596869,142849468,144640716,145245148,641.4648176339078,14.549195130428728
Thailand,Switzerland,8699,11088,13518,15115,17839,19065,20958,12259,1.409242441659961,4819,0.3564876461014943,3119,0.17484163910533101,1893,0.0992918961447679,THA,CHE,63066603,68270489,70294397,71475664,7184250,7824909,8282396,8638167,29.321868209576902,242.62091714596394
China,Jordan,192,5718,11240,8438,17420,16121,20896,20704,107.83333333333333,11048,0.9829181494661922,3476,0.19954075774971297,4775,0.2961975063581664,CHN,JOR,1262645000,1337705000,1379860000,1411100000,5056174,6931258,9494246,10928721,1.4808305577209269,191.2026119067364
Thailand,France,12071,12461,12851,14139,17044,18890,20763,8692,0.7200729019965206,780,0.06069566570694888,3719,0.21819995306266135,1873,0.09915299100052938,THA,FRA,63066603,68270489,70294397,71475664,60921384,65030575,66548272,67571107,29.049048078797842,30.727630376101434
United States of America,China,4288,6532,8474,12251,15475,19088,20762,16474,3.841884328358209,4186,0.4939815907481709,5287,0.34164781906300484,1674,0.08769907795473596,USA,CHN,282162411,309327143,320738994,331526933,1262645000,1337705000,1379860000,1411100000,6.262537951931646,1.4713344199560625
Vietnam,Laos,13852,13368,11611,10717,14827,18938,20270,6418,0.46332659543748195,-2241,-0.19300663164240806,5443,0.36710055978957307,1332,0.07033477663956067,VNM,LAO,79001142,87411012,92191398,96648685,5430853,6323418,6787419,7319399,20.972866832073297,276.93530575392873
Vietnam,Sweden,8563,10162,10898,12180,13942,15907,20245,11682,1.3642415041457434,2335,0.21425949715544138,6303,0.4520872184765457,4338,0.2727101276167725,VNM,SWE,79001142,87411012,92191398,96648685,8872109,9378126,9799186,10353442,20.946999951421997,195.5388362633412
Thailand,Hong Kong,12860,14353,15845,17299,18795,19208,20028,7168,0.5573872472783826,2985,0.18838750394446196,1233,0.06560255387071029,820,0.0426905456059975,THA,HKG,63066603,68270489,70294397,71475664,6665000,7024200,7291300,7481000,28.02072604739985,267.71821948937304
Japan,Indonesia,12535,8293,4052,10237,17080,18909,19879,7344,0.5858795372955724,-8483,-2.093534057255676,2799,0.16387587822014052,970,0.05129832354963245,JPN,IDN,126843000,128070000,127141000,126261000,214072421,244016173,259091970,271857970,15.744370787495743,7.312274126081351
Canada,South Korea,513,1818,3703,7358,13922,11589,19435,18922,36.8849902534113,3190,0.8614636780988387,5513,0.3959919551788536,7846,0.6770213133143498,CAN,KOR,30685730,34005902,35704498,38028638,47008111,49554112,51014947,51836239,51.10622157964216,37.49307506665366
China,Nepal,21906,25260,22820,20155,20977,20302,19428,-2478,-0.11311969323473021,914,0.04005258545135846,-1549,-0.07384278018782477,-874,-0.043049945818145995,CHN,NPL,1262645000,1337705000,1379860000,1411100000,24559500,27161567,27610325,29348627,1.3767982425058465,66.1973045621521
Cambodia,Bangladesh,12924,13190,13455,16015,18541,19642,19259,6335,0.49017332095326527,531,0.03946488294314381,718,0.03872498786473221,-383,-0.01949903268506262,KHM,BGD,12118841,14363532,15417523,16396860,129193327,148391139,157830000,167420951,117.4554152441382,11.503339268452727
Japan,Malaysia,5255,6016,8490,12057,14764,18004,19078,13823,2.6304471931493816,3235,0.38103651354534745,4314,0.29219723652126794,1074,0.05965341035325483,JPN,MYS,126843000,128070000,127141000,126261000,22945150,28717731,31068833,33199993,15.10997061642154,57.46386753756243
Indonesia,Jordan,183,6415,12641,9489,19589,14677,19024,18841,102.95628415300547,12458,0.9855232972074994,-565,-0.028842717851855635,4347,0.29617769298903046,IDN,JOR,214072421,244016173,259091970,271857970,5056174,6931258,9494246,10928721,6.997771667315841,174.07343457665357
"China, Macao SAR",China,3099,4494,5574,9755,14100,17393,18918,15819,5.104549854791868,2475,0.44402583423035524,4818,0.3417021276595745,1525,0.08767895130224804,MAC,CHN,431896,557297,615239,676283,1262645000,1337705000,1379860000,1411100000,2797.3496302583385,1.340656225639572
India,Hong Kong,12064,13464,14864,16228,17632,18019,18788,6724,0.5573607427055703,2800,0.1883745963401507,1156,0.06556261343012704,769,0.04267717409401187,IND,HKG,1059633675,1240613620,1322866505,1396387127,6665000,7024200,7291300,7481000,1.345472157163477,251.14289533484828
Afghanistan,Italy,271,236,201,3384,5549,14893,18689,18418,67.96309963099631,-70,-0.3482587064676617,13140,2.36799423319517,3796,0.2548848452293024,AFG,ITA,19542982,28189672,33753499,38972230,56942108,59277417,60730582,59438851,47.95465899693192,31.442397835045636
Iran,Italy,19096,14034,8971,11701,14360,14869,18529,-567,-0.02969208211143695,-10125,-1.1286367183145691,4169,0.29032033426183845,3660,0.24614970744501985,IRN,ITA,65544383,75373855,81790841,87290193,56942108,59277417,60730582,59438851,21.226897734090244,31.17321362756491
United Kingdom,Hong Kong,11838,13212,14585,15924,17301,17681,18436,6598,0.5573576617671904,2747,0.18834418923551594,1135,0.06560314432691752,755,0.042701204682993044,GBR,HKG,58892514,62766365,65116219,67081234,6665000,7024200,7291300,7481000,27.48309609212019,246.43764202646707
India,Israel,16927,18225,18502,18334,18389,18965,18415,1488,0.0879068943108643,1575,0.08512593233163983,26,0.0014138887378323999,-550,-0.029000790930661744,IND,ISR,1059633675,1240613620,1322866505,1396387127,6289000,7623600,8380100,9215100,1.3187603669451473,199.8350533363718
Iran,Norway,5198,7055,8857,11527,13037,16043,18379,13181,2.535782993459023,3659,0.41311956644462006,5342,0.4097568459001304,2336,0.1456086766814187,IRN,NOR,65544383,75373855,81790841,87290193,4490967,4889252,5188607,5379475,21.055057124229293,341.65043986634385
Thailand,Singapore,1438,3032,4921,10010,15658,17962,18253,16815,11.693324061196106,3483,0.7077829709408657,2595,0.16572997828586025,291,0.01620086850016702,THA,SGP,63066603,68270489,70294397,71475664,4027887,5076732,5535002,5685807,25.53736331851356,321.02742847233475
China,Austria,9703,10934,12165,13545,15095,14883,17776,8073,0.8320107183345357,2462,0.20238388820386355,2681,0.17760847962901624,2893,0.1943828529194383,CHN,AUT,1262645000,1337705000,1379860000,1411100000,8011566,8363404,8642699,8916864,1.259726454539012,199.35259750513185
China,Hungary,941,4242,7543,9259,11058,13867,17648,16707,17.75451647183847,6602,0.8752485748375978,6590,0.5959486344727799,3781,0.27266171486262347,CHN,HUN,1262645000,1337705000,1379860000,1411100000,10210971,10000023,9843028,9750149,1.2506555169725746,181.00236211774813
Philippines,Ireland,774,2741,6214,11553,14989,15312,17557,16783,21.683462532299743,5440,0.8754425490827165,2568,0.17132563880178797,2245,0.14661703239289448,PHL,IRL,77958223,94636700,103031365,112190977,3805174,4560155,4701957,4985382,15.649208581185635,352.1696030514813
Philippines,France,7979,8237,8495,10645,14295,15843,17414,9435,1.1824790073944103,516,0.0607416127133608,3119,0.21818817768450507,1571,0.09916051252919271,PHL,FRA,77958223,94636700,103031365,112190977,60921384,65030575,66548272,67571107,15.52174735050217,25.77137000286232
Afghanistan,Norway,253,351,638,5023,8836,13124,17242,16989,67.1501976284585,385,0.603448275862069,8406,0.9513354459031236,4118,0.31377628771715943,AFG,NOR,19542982,28189672,33753499,38972230,4490967,4889252,5188607,5379475,44.24175881133823,320.5145483527667
Iran,Denmark,8022,9753,11483,11970,11938,14600,17125,9103,1.1347544253303417,3461,0.3014020726291039,5187,0.4344948902663763,2525,0.17294520547945205,IRN,DNK,65544383,75373855,81790841,87290193,5339616,5547683,5683483,5831404,19.618469625791754,293.66855734913923
Pakistan,Sweden,2435,2890,3100,4653,9127,10698,16597,14162,5.8160164271047226,665,0.21451612903225806,7470,0.8184507505204339,5899,0.5514114787810805,PAK,SWE,154369924,194454498,210969298,227196741,8872109,9378126,9799186,10353442,7.305122391698392,160.30417710361445
Pakistan,Japan,2068,4818,7499,9714,10299,12708,16434,14366,6.946808510638298,5431,0.7242298973196426,6135,0.5956889018351296,3726,0.29320113314447593,PAK,JPN,154369924,194454498,210969298,227196741,126843000,128070000,127141000,126261000,7.233378404842524,13.015895644735904
Cambodia,Malaysia,747,1770,3413,8592,12679,15461,16384,15637,20.933065595716197,2666,0.7811309698212716,3705,0.2922154744064989,923,0.05969859646853373,KHM,MYS,12118841,14363532,15417523,16396860,22945150,28717731,31068833,33199993,99.92157034944495,49.349407995357105
Thailand,Canada,5585,7052,8687,11281,13360,14982,16232,10647,1.9063563115487914,3102,0.357085299873374,2872,0.2149700598802395,1250,0.08343345347750634,THA,CAN,63066603,68270489,70294397,71475664,30685730,34005902,35704498,38028638,22.709827501567524,42.683621748430745
Afghanistan,India,14159,19916,12794,15792,18085,16851,16094,1935,0.13666219365774418,-1365,-0.1066906362357355,-1991,-0.11009123583079901,-757,-0.04492314996142662,AFG,IND,19542982,28189672,33753499,38972230,1059633675,1240613620,1322866505,1396387127,41.29607158738415,1.1525457152112517
Malaysia,Hong Kong,10234,11422,12609,13766,14957,15286,15939,5705,0.5574555403556771,2375,0.1883575224046316,982,0.06565487731496958,653,0.042718827685463825,MYS,HKG,22945150,28717731,31068833,33199993,6665000,7024200,7291300,7481000,48.00904626696759,213.05975137013766
China,Chile,1124,1691,2258,3733,5208,7889,15921,14797,13.16459074733096,1134,0.5022143489813995,10713,2.0570276497695854,8032,1.0181265052604893,CHN,CHL,1262645000,1337705000,1379860000,1411100000,15351799,17004162,17870124,19300315,1.1282687265254057,82.49088162550716
Thailand,Malaysia,31127,29090,34501,19811,18929,14901,15790,-15337,-0.4927233591415813,3374,0.09779426683284542,-3139,-0.16583020761794073,889,0.05966042547480035,THA,MYS,63066603,68270489,70294397,71475664,22945150,28717731,31068833,33199993,22.091435205134996,47.560250991619185
Thailand,Netherlands,2502,4141,5917,9704,11998,13798,15753,13251,5.296163069544365,3415,0.5771505830657427,3755,0.312968828138023,1955,0.1416872010436295,THA,NLD,63066603,68270489,70294397,71475664,15925513,16615394,16939923,17441500,22.03966933416666,90.31906659404294
Bangladesh,Japan,2110,5003,7177,9597,10175,10835,15702,13592,6.441706161137441,5067,0.7060052946913752,5527,0.5431941031941032,4867,0.4491924319335487,BGD,JPN,129193327,148391139,157830000,167420951,126843000,128070000,127141000,126261000,9.378754514421555,12.436144177537006
Thailand,Brunei Darussalam,6612,10047,13482,13782,14083,14384,15674,9062,1.3705384150030249,6870,0.5095683133066311,1591,0.11297308812042889,1290,0.08968298109010012,THA,BRN,63066603,68270489,70294397,71475664,333926,396053,421437,441725,21.9291422042613,3548.36153715547
Laos,Canada,13860,13854,14178,13739,14305,14386,15587,1727,0.1246031746031746,318,0.022429115531104528,1282,0.08961901433065361,1201,0.08348394272209092,LAO,CAN,5430853,6323418,6787419,7319399,30685730,34005902,35704498,38028638,212.95464286070484,40.987531554509
Bangladesh,South Africa,2469,1540,1064,1400,12182,22965,15565,13096,5.30417172944512,-1405,-1.3204887218045114,3383,0.27770481037596456,-7400,-0.3222294796429349,BGD,ZAF,129193327,148391139,157830000,167420951,46813266,51784921,55876504,58801927,9.296924851418387,26.47022095041205
Nepal,Canada,120,620,1134,4820,8345,14301,15495,15375,128.125,1014,0.8941798941798942,7150,0.8568004793289394,1194,0.08349066498846235,NPL,CAN,24559500,27161567,27610325,29348627,30685730,34005902,35704498,38028638,52.79633694618832,40.74560861212016
Philippines,Netherlands,3077,4794,6671,8609,10580,12403,15455,12378,4.022749431264218,3594,0.5387498126217959,4875,0.4607750472589792,3052,0.24606949931468194,PHL,NLD,77958223,94636700,103031365,112190977,15925513,16615394,16939923,17441500,13.775617623866488,88.61049795029098
Indonesia,Canada,7298,8723,10356,12039,13520,14192,15377,8079,1.1070156207180049,3058,0.29528775589030515,1857,0.13735207100591715,1185,0.0834977452085682,IDN,CAN,214072421,244016173,259091970,271857970,30685730,34005902,35704498,38028638,5.6562623490493955,40.435316142534475
Canada,Hong Kong,8414,11844,15273,14797,14357,14672,15298,6884,0.8181602091751842,6859,0.44909317095528056,941,0.06554294072577836,626,0.04266630316248637,CAN,HKG,30685730,34005902,35704498,38028638,6665000,7024200,7291300,7481000,40.22757796374406,204.4913781580003
Afghanistan,Switzerland,1756,2243,2740,3300,3617,11929,15036,13280,7.562642369020502,984,0.35912408759124087,11419,3.1570362178601052,3107,0.2604577081062956,AFG,CHE,19542982,28189672,33753499,38972230,7184250,7824909,8282396,8638167,38.58131803081322,174.0647060886876
India,Austria,7478,8436,9394,10416,11569,12586,14992,7514,1.0048141214228403,1916,0.20395997445177774,3423,0.295876912438413,2406,0.19116478627045924,IND,AUT,1059633675,1240613620,1322866505,1396387127,8011566,8363404,8642699,8916864,1.073627771992487,168.13085856193388
Philippines,Singapore,1175,2480,4027,8195,12820,14706,14944,13769,11.718297872340425,2852,0.7082195182518003,2124,0.1656786271450858,238,0.016183870529035766,PHL,SGP,77958223,94636700,103031365,112190977,4027887,5076732,5535002,5685807,13.320144275060551,262.82988501016655
Sri Lanka,New Zealand,2298,3913,6001,6940,8516,9956,14916,12618,5.490861618798956,3703,0.6170638226962173,6400,0.751526538280883,4960,0.49819204499799113,LKA,NZL,18776371,20668557,21336697,21919000,3857700,4350700,4609400,5090200,68.05054975135728,293.03367254724765
Philippines,Sweden,4290,5091,5460,7137,9226,11458,14878,10588,2.468065268065268,1170,0.21428571428571427,5652,0.6126165185345762,3420,0.2984814103683016,PHL,SWE,77958223,94636700,103031365,112190977,8872109,9378126,9799186,10353442,13.261316014745109,143.70100300943398
Japan,Hong Kong,9505,10608,11711,12786,13892,14197,14803,5298,0.5573908469226723,2206,0.18836990863290923,911,0.06557731068240714,606,0.04268507431147425,JPN,HKG,126843000,128070000,127141000,126261000,6665000,7024200,7291300,7481000,11.724127006755847,197.87461569308914
India,Norway,4422,4621,5130,5806,8132,11845,14726,10304,2.3301673450927183,708,0.13801169590643275,6594,0.8108706345302509,2881,0.24322498944702406,IND,NOR,1059633675,1240613620,1322866505,1396387127,4490967,4889252,5188607,5379475,1.0545786132845094,273.7441850738223
Vietnam,Netherlands,7130,8861,10560,12081,12119,12522,14712,7582,1.0633941093969144,3430,0.3248106060606061,2593,0.2139615479825068,2190,0.17489218974604695,VNM,NLD,79001142,87411012,92191398,96648685,15925513,16615394,16939923,17441500,15.222141925676485,84.35054324456038
Philippines,Brunei Darussalam,7837,10226,12614,12895,13176,13457,14664,6827,0.8711241546510144,4777,0.37870619946091644,1488,0.11293260473588343,1207,0.08969309652968716,PHL,BRN,77958223,94636700,103031365,112190977,333926,396053,421437,441725,13.070569837358667,3319.7124908031014
India,Denmark,2604,3498,4391,6325,7901,10006,14638,12034,4.621351766513057,1787,0.40696879981780915,6737,0.8526768763447665,4632,0.4629222466520088,IND,DNK,1059633675,1240613620,1322866505,1396387127,5339616,5547683,5683483,5831404,1.0482766359675844,251.0201659840409
Japan,Philippines,2891,3890,6249,5057,13537,13749,14634,11743,4.061916291940505,3358,0.5373659785565691,1097,0.08103715742040334,885,0.06436831769583243,JPN,PHL,126843000,128070000,127141000,126261000,77958223,94636700,103031365,112190977,11.590277282771401,13.043829719033464
Brazil,Bangladesh,552,5387,10221,12165,14083,14919,14628,14076,25.5,9669,0.9459935427061932,545,0.03869914080806646,-291,-0.01950532877538709,BRA,BGD,175873720,196353492,205188205,213196304,129193327,148391139,157830000,167420951,6.861282173071817,8.737257740221533
India,Maldives,951,6418,11427,13773,13568,13364,14596,13645,14.348054679284964,10476,0.9167760567077973,1028,0.07576650943396226,1232,0.092187967674349,IND,MDV,1059633675,1240613620,1322866505,1396387127,282507,361575,435582,514438,1.0452688740663247,2837.2709636535405
Vietnam,Norway,7522,10594,11177,11993,12919,13682,14596,7074,0.9404413719755385,3655,0.3270108258029883,1677,0.12980880873132594,914,0.06680309896214004,VNM,NOR,79001142,87411012,92191398,96648685,4490967,4889252,5188607,5379475,15.102119599454456,271.3275923765795
Bangladesh,Spain,248,387,693,4383,10533,9836,14594,14346,57.846774193548384,445,0.6421356421356421,4061,0.38555017563846955,4758,0.48373322488816595,BGD,ESP,129193327,148391139,157830000,167420951,40567864,46576897,46444832,47365655,8.716949648673301,30.811354767499786
China,Denmark,1301,2441,3580,7194,10328,11988,14576,13275,10.20368946963874,2279,0.6365921787709498,4248,0.4113090627420604,2588,0.21588254921588254,CHN,DNK,1262645000,1337705000,1379860000,1411100000,5339616,5547683,5683483,5831404,1.0329530153780737,249.9569571924703
China,Ireland,563,3056,7229,10704,12416,12683,14542,13979,24.82948490230906,6666,0.9221192419421773,2126,0.17123067010309279,1859,0.14657415437987859,CHN,IRL,1262645000,1337705000,1379860000,1411100000,3805174,4560155,4701957,4985382,1.0305435475869889,291.69279304976027
Iran,Iraq,14976,44953,42602,17651,18029,14405,14540,-436,-0.029113247863247864,27626,0.6484672081122952,-3489,-0.19352154861611848,135,0.009371745921555015,IRN,IRQ,65544383,75373855,81790841,87290193,24628858,31264875,37757813,42556984,16.65708311585472,34.165954993427164
China,Argentina,4268,5850,7432,9956,12476,14397,14537,10269,2.406044985941893,3164,0.42572658772874056,2061,0.16519717858287913,140,0.009724248107244565,CHN,ARG,1262645000,1337705000,1379860000,1411100000,37070774,40788453,43131966,45376763,1.0301892140883,32.03622082959069
Myanmar,United Kingdom,10359,9891,9590,10172,10738,12851,14505,4146,0.40023168259484504,-769,-0.08018769551616267,3767,0.35081020674241015,1654,0.12870593728114543,MMR,GBR,45538332,49390988,51483949,53423198,58892514,62766365,65116219,67081234,27.151126370233396,21.623036928628952
Philippines,Switzerland,7161,8124,9117,10167,12032,12997,14455,7294,1.018572825024438,1956,0.21454425797959856,2423,0.20137965425531915,1458,0.11217973378471956,PHL,CHE,77958223,94636700,103031365,112190977,7184250,7824909,8282396,8638167,12.884280346359759,167.33874211971127
Saudi Arabia,India,6058,5767,5476,11769,16579,15448,14448,8390,1.3849455265764279,-582,-0.10628195763330898,-2131,-0.1285360998853972,-1000,-0.0647332988089073,SAU,IND,21547390,29411929,32749848,35997107,1059633675,1240613620,1322866505,1396387127,40.1365587517908,1.0346700940333147
China,Laos,4125,3743,3005,2820,8110,13400,14338,10213,2.475878787878788,-1120,-0.37271214642262895,6228,0.7679408138101109,938,0.07,CHN,LAO,1262645000,1337705000,1379860000,1411100000,5430853,6323418,6787419,7319399,1.016086740840479,195.89040029106215
Pakistan,Denmark,6946,8498,10049,10743,10959,13144,14318,7372,1.0613302620213072,3103,0.30878694397452483,3359,0.3065060680719044,1174,0.08931832014607426,PAK,DNK,154369924,194454498,210969298,227196741,5339616,5547683,5683483,5831404,6.302027017192118,245.5326367372249
Thailand,Denmark,1958,3777,5596,8144,10227,12322,14225,12267,6.265066394279877,3638,0.6501072194424589,3998,0.39092598024836217,1903,0.1544392144132446,THA,DNK,63066603,68270489,70294397,71475664,5339616,5547683,5683483,5831404,19.901878770933838,243.93782354986894
Pakistan,Netherlands,6717,8428,10427,10752,11191,11822,14104,7387,1.0997469108232842,3710,0.35580703941689845,2913,0.26029845411491376,2282,0.19302994417188293,PAK,NLD,154369924,194454498,210969298,227196741,15925513,16615394,16939923,17441500,6.207835525246377,80.8646045351604
Norway,Bangladesh,4240,7022,9804,11669,13509,14311,14032,9792,2.309433962264151,5564,0.5675234598123216,523,0.03871493078688282,-279,-0.01949549297742995,NOR,BGD,4490967,4889252,5188607,5379475,129193327,148391139,157830000,167420951,260.84329790546474,8.381268841317238
Indonesia,Libya,4228,6863,9612,10595,11627,13019,13944,9716,2.2980132450331126,5384,0.5601331668747399,2317,0.19927754364840458,925,0.07105000384054075,IDN,LBY,214072421,244016173,259091970,271857970,5154790,6491988,6192235,6653942,5.129148871375741,209.55998714746838
United States of America,Hong Kong,7599,10698,13796,13370,12976,13261,13827,6228,0.8195815238847217,6197,0.44918817048419835,851,0.0655826140567201,566,0.04268154739461579,USA,HKG,282162411,309327143,320738994,331526933,6665000,7024200,7291300,7481000,4.170701871754112,184.82823151985028
Afghanistan,Denmark,354,1648,2941,6609,9817,12293,13715,13361,37.74293785310734,2587,0.879632777966678,3898,0.39706631353774063,1422,0.11567558773285609,AFG,DNK,19542982,28189672,33753499,38972230,5339616,5547683,5683483,5831404,35.19172497955596,235.1920738127559
Vietnam,Russian Federation,32251,28489,23695,18748,13416,13671,13662,-18589,-0.5763852283650119,-8556,-0.36108883730744884,246,0.018336314847942754,-9,-6.583278472679394e-4,VNM,RUS,79001142,87411012,92191398,96648685,146596869,142849468,144640716,145245148,14.135732938321924,9.406166187389612
Bangladesh,Germany,4767,5304,5841,6009,6102,6262,13612,8845,1.855464652821481,1074,0.18387262455059064,7510,1.2307440183546379,7350,1.1737464068987544,BGD,DEU,129193327,148391139,157830000,167420951,82211508,81776930,81686611,83160871,8.130404181015553,16.36827493064617
Malaysia,India,12295,13758,15220,15439,15607,14542,13601,1306,0.10622204148027653,2925,0.1921813403416557,-2006,-0.1285320689434228,-941,-0.06470911841562371,MYS,IND,22945150,28717731,31068833,33199993,1059633675,1240613620,1322866505,1396387127,40.96687610747388,0.9740135623579119
Indonesia,Papua New Guinea,8108,7293,6663,9806,13219,13527,13592,5484,0.6763690182535768,-1445,-0.21686927810295661,373,0.02821696043573644,65,0.004805204406002809,IDN,PNG,214072421,244016173,259091970,271857970,5508297,7583269,8682174,9749640,4.999669496538946,139.4102756614603
China,Norway,1862,2878,3617,5938,9823,12197,13579,11717,6.292696025778732,1755,0.48520873652197954,3756,0.382367912043164,1382,0.11330655079117816,CHN,NOR,1262645000,1337705000,1379860000,1411100000,4490967,4889252,5188607,5379475,0.962298915739494,252.4224018143034
Japan,Bangladesh,9042,9330,9618,11317,13041,13763,13494,4452,0.49236894492368943,576,0.05988771054273238,453,0.03473659995399126,-269,-0.019545157305819953,JPN,BGD,126843000,128070000,127141000,126261000,129193327,148391139,157830000,167420951,10.687385653527217,8.059923157406985
Pakistan,South Africa,1523,2469,4181,5528,12444,19360,13325,11802,7.749179251477347,2658,0.6357330782109544,881,0.07079717132754741,-6035,-0.31172520661157027,PAK,ZAF,154369924,194454498,210969298,227196741,46813266,51784921,55876504,58801927,5.864960888677537,22.66082198292583
Philippines,Austria,7633,8611,9589,10632,11807,12138,13297,5664,0.7420411371675619,1956,0.20398373135884867,1490,0.12619632421444907,1159,0.0954852529246993,PHL,AUT,77958223,94636700,103031365,112190977,8011566,8363404,8642699,8916864,11.852111779006968,149.12193345104288
Pakistan,Belgium,3767,4078,4270,6746,8705,11995,13246,9479,2.5163259888505443,503,0.11779859484777518,4541,0.52165422171166,1251,0.10429345560650272,PAK,BEL,154369924,194454498,210969298,227196741,10251250,10895586,11274196,11538604,5.830189263146165,114.79724930329527
Iran,Switzerland,4686,5372,6078,6952,8021,9731,13094,8408,1.7942808365343577,1392,0.22902270483711748,5073,0.6324647799526244,3363,0.3455965471174597,IRN,CHE,65544383,75373855,81790841,87290193,7184250,7824909,8282396,8638167,15.000539636795166,151.5830846984088
China,Venezuela (Bolivarian Republic of),6458,8067,9988,11278,12864,13865,13071,6613,1.0240012387736142,3530,0.35342410893071685,207,0.016091417910447763,-794,-0.0572664983772088,CHN,VEN,1262645000,1337705000,1379860000,1411100000,24427729,28715022,30529716,28490453,0.926298632272695,45.87852639619314
Bangladesh,France,2198,2269,2340,3164,4690,7726,12878,10680,4.858962693357598,142,0.06068376068376068,8188,1.7458422174840085,5152,0.6668392441107948,BGD,FRA,129193327,148391139,157830000,167420951,60921384,65030575,66548272,67571107,7.6919883222978465,19.058441650215972
Thailand,United Arab Emirates,2228,2855,3647,4842,10763,11760,12819,10591,4.753590664272891,1419,0.3890869207567864,2056,0.1910248072098857,1059,0.09005102040816326,THA,ARE,63066603,68270489,70294397,71475664,3275333,8481771,8916899,9287289,17.934775674137146,138.02736191368655
United States of America,Indonesia,8745,5786,2827,6654,10909,12077,12697,3952,0.451915380217267,-5918,-2.093385214007782,1788,0.16390136584471537,620,0.051337252628964145,USA,IDN,282162411,309327143,320738994,331526933,214072421,244016173,259091970,271857970,3.8298547527057174,4.670453472451074
Sri Lanka,Bahrain,5863,5119,4391,6038,9019,9777,12667,6804,1.160498038546819,-1472,-0.3352311546344796,3648,0.4044794323095687,2890,0.29559169479390407,LKA,BHR,18776371,20668557,21336697,21919000,711442,1213645,1362142,1477469,57.79004516629408,857.3445534221022
Vietnam,Ukraine,14964,14476,14166,12943,12349,12390,12596,-2368,-0.1582464581662657,-798,-0.05633206268530284,247,0.020001619564337193,206,0.01662631154156578,VNM,UKR,79001142,87411012,92191398,96648685,49176500,45870741,45167350,44207754,13.032769147350532,28.49273907921221
India,Indonesia,7818,5172,2527,6465,10818,11976,12590,4772,0.6103862880532105,-5291,-2.0937870993272654,1772,0.1638010722869292,614,0.051269205076820305,IND,IDN,1059633675,1240613620,1322866505,1396387127,214072421,244016173,259091970,271857970,0.9016124365918764,4.631094685213753
Jordan,Indonesia,4851,3209,1568,6000,10818,11976,12590,7739,1.5953411667697381,-3283,-2.09375,1772,0.1638010722869292,614,0.051269205076820305,JOR,IDN,5056174,6931258,9494246,10928721,214072421,244016173,259091970,271857970,115.20103770605911,4.631094685213753
Pakistan,Iran,9925,8297,15251,18233,19207,16032,12575,2650,0.26700251889168763,5326,0.34922300177037574,-6632,-0.3452907794033425,-3457,-0.2156312375249501,PAK,IRN,154369924,194454498,210969298,227196741,65544383,75373855,81790841,87290193,5.534850519708819,14.405971126676281
Sri Lanka,Jordan,11062,13104,15147,11370,23474,9689,12559,1497,0.13532815042487797,4085,0.26969036772958344,-10915,-0.4649825338672574,2870,0.296212199401383,LKA,JOR,18776371,20668557,21336697,21919000,5056174,6931258,9494246,10928721,57.29732195811853,114.91738145753745
Afghanistan,Tajikistan,8485,12248,17118,12636,12606,12393,12433,3948,0.46529169121979963,8633,0.504322934922304,-173,-0.01372362367126765,40,0.0032276284999596546,AFG,TJK,19542982,28189672,33753499,38972230,6272998,7621779,8524063,9543207,31.902203184164723,130.28115181825146
Vietnam,Switzerland,7338,7764,8220,9147,10847,11272,12263,4925,0.6711638048514582,882,0.1072992700729927,1416,0.13054300728311977,991,0.08791696238466998,VNM,CHE,79001142,87411012,92191398,96648685,7184250,7824909,8282396,8638167,12.688222297075228,141.96298821266132
South Korea,United Kingdom,1717,6750,11898,8591,9070,10856,12253,10536,6.13628421665696,10181,0.8556900319381409,3183,0.3509371554575524,1397,0.12868459837877672,KOR,GBR,47008111,49554112,51014947,51836239,58892514,62766365,65116219,67081234,23.637903205130296,18.265913235883527
Thailand,Vietnam,1218,2995,7145,8148,9570,11552,12192,10974,9.009852216748769,5927,0.8295311406578026,2622,0.27398119122257053,640,0.055401662049861494,THA,VNM,63066603,68270489,70294397,71475664,79001142,87411012,92191398,96648685,17.05755402286294,12.614760356025537
Philippines,Denmark,1972,2951,3929,6631,8921,10772,12121,10149,5.146551724137931,1957,0.4980911173326546,3200,0.3587041811456115,1349,0.1252320831786112,PHL,DNK,77958223,94636700,103031365,112190977,5339616,5547683,5683483,5831404,10.803899140659057,207.85731875205354
Bangladesh,South Korea,658,4103,8855,7318,8670,7432,12102,11444,17.39209726443769,8197,0.9256916996047431,3432,0.3958477508650519,4670,0.6283638320775027,BGD,KOR,129193327,148391139,157830000,167420951,47008111,49554112,51014947,51836239,7.2284859975499725,23.34660120692784
China,Malaysia,91377,65974,54430,29909,9306,11347,12024,-79353,-0.8684132768639811,-36947,-0.6787984567334191,2718,0.29206963249516443,677,0.05966334714021327,CHN,MYS,1262645000,1337705000,1379860000,1411100000,22945150,28717731,31068833,33199993,0.8521011976472255,36.216875105967645
China,Portugal,673,1452,2291,6280,9227,10461,12000,11327,16.830609212481427,1618,0.7062418158009602,2773,0.30053105017882303,1539,0.14711786636076857,CHN,PRT,1262645000,1337705000,1379860000,1411100000,10289898,10573100,10358076,10297081,0.8504003968535185,116.53788097811409
Iran,Belgium,3157,2480,1731,4428,8564,10554,11918,8761,2.7751029458346532,-1426,-0.8238012709416522,3354,0.3916394208313872,1364,0.1292400985408376,IRN,BEL,65544383,75373855,81790841,87290193,10251250,10895586,11274196,11538604,13.65330925548532,103.2880580701097
Laos,Australia,11172,11315,10450,10599,11110,11030,11912,740,0.06623702112423917,-722,-0.06909090909090909,802,0.07218721872187218,882,0.0799637352674524,LAO,AUS,5430853,6323418,6787419,7319399,19028802,22031750,23815995,25649248,162.74560247364573,46.441907380676426
Myanmar,Vietnam,963,2690,6807,7834,9356,11187,11796,10833,11.249221183800623,5844,0.8585279858968708,2440,0.26079521162890124,609,0.05443818718155001,MMR,VNM,45538332,49390988,51483949,53423198,79001142,87411012,92191398,96648685,22.08029553004296,12.20502896650896
Kuwait,India,16860,12149,7437,10884,13519,12597,11781,-5079,-0.30124555160142347,-9423,-1.2670431625655507,-1738,-0.12855980471928397,-816,-0.06477732793522267,KWT,IND,1934901,2943356,3908743,4360444,1059633675,1240613620,1322866505,1396387127,270.1789083863937,0.8436772133033277
Thailand,China,1477,3024,4808,6950,8780,10830,11779,10302,6.974949221394719,3331,0.6928036605657238,2999,0.34157175398633255,949,0.0876269621421976,THA,CHN,63066603,68270489,70294397,71475664,1262645000,1337705000,1379860000,1411100000,16.479734976648835,0.8347388562114662
Philippines,Belgium,7502,8282,8127,8392,8444,10423,11778,4276,0.569981338309784,625,0.07690414667158853,3334,0.39483657034580766,1355,0.13000095941667467,PHL,BEL,77958223,94636700,103031365,112190977,10251250,10895586,11274196,11538604,10.498170454474248,102.07473971721363
Hong Kong,New Zealand,4839,11441,10996,7350,7401,7334,11734,6895,1.4248811737962388,6157,0.5599308839578029,4333,0.5854614241318741,4400,0.5999454595036815,HKG,NZL,6665000,7024200,7291300,7481000,3857700,4350700,4609400,5090200,156.8506884106403,230.5213940513143
Bangladesh,Jordan,948,4677,8402,9088,21853,9021,11693,10745,11.334388185654008,7454,0.8871697214948822,-10160,-0.4649247242941473,2672,0.2961977607804013,BGD,JOR,129193327,148391139,157830000,167420951,5056174,6931258,9494246,10928721,6.9841916021609505,106.9933069020611
South Korea,Sweden,7205,8550,9170,9693,10194,10271,11641,4436,0.6156835530881333,1965,0.21428571428571427,1447,0.1419462428879733,1370,0.13338525946840618,KOR,SWE,47008111,49554112,51014947,51836239,8872109,9378126,9799186,10353442,22.457261993872667,112.43603817938035
Nepal,Thailand,5763,9634,15494,12472,10345,11099,11618,5855,1.0159639076869686,9731,0.628049567574545,1273,0.12305461575640406,519,0.04676096945670781,NPL,THA,24559500,27161567,27610325,29348627,63066603,68270489,70294397,71475664,39.5861789377745,16.254483484056895
China,Finland,428,1106,1783,4541,6591,9069,11614,11186,26.135514018691588,1355,0.7599551318003365,5023,0.7620998331057502,2545,0.2806263094056677,CHN,FIN,1262645000,1337705000,1379860000,1411100000,5176209,5363352,5479531,5529543,0.8230458507547305,210.0354405418314
United Kingdom,Malaysia,3433,3930,5547,7431,8842,10782,11425,7992,2.3279930090300027,2114,0.381106904633135,2583,0.29212847771997286,643,0.05963643108885179,GBR,MYS,58892514,62766365,65116219,67081234,22945150,28717731,31068833,33199993,17.031588894145866,34.41265785809051
China,Mongolia,1649,1821,2013,4994,8546,10595,11419,9770,5.924802910855064,364,0.18082463984103328,2873,0.33618066931897966,824,0.07777253421425201,CHN,MNG,1262645000,1337705000,1379860000,1411100000,2450979,2702520,2964749,3294335,0.8092268443058608,346.62534320280116
Vietnam,Hong Kong,7324,8174,9023,9852,10704,10939,11406,4082,0.5573457127252868,1699,0.18829657541837527,702,0.0655829596412556,467,0.042691288051924306,VNM,HKG,79001142,87411012,92191398,96648685,6665000,7024200,7291300,7481000,11.801505628348695,152.4662478278305
Australia,Indonesia,5963,3945,1928,5679,9796,10844,11400,5437,0.9117893677679021,-4035,-2.0928423236514524,1604,0.16374030216414864,556,0.05127259313906308,AUS,IDN,19028802,22031750,23815995,25649248,214072421,244016173,259091970,271857970,44.44574749325984,4.193366116873454
North Korea,United Kingdom,0,5,11,7984,8428,10087,11385,11385,1,11,1,2957,0.35085429520645467,1298,0.128680479825518,PRK,GBR,23367059,24686435,25258015,25867467,58892514,62766365,65116219,67081234,44.01281346952139,16.97195969889284
Thailand,Italy,568,2205,3842,6853,9476,9827,11338,10770,18.961267605633804,3274,0.8521603331598125,1862,0.19649641198818066,1511,0.15376004884501882,THA,ITA,63066603,68270489,70294397,71475664,56942108,59277417,60730582,59438851,15.862741757810044,19.075065902602997
India,Philippines,2611,3513,4632,3749,10476,10639,11323,8712,3.3366526235158944,2021,0.4363126079447323,847,0.08085147002672775,684,0.06429175674405489,IND,PHL,1059633675,1240613620,1322866505,1396387127,77958223,94636700,103031365,112190977,0.8108782859038773,10.092611993208687
Thailand,New Zealand,2671,4372,5014,5890,7012,8023,11205,8534,3.195058030700112,2343,0.46729158356601513,4193,0.5979749001711352,3182,0.39660974697743984,THA,NZL,63066603,68270489,70294397,71475664,3857700,4350700,4609400,5090200,15.676664437842788,220.12887509331654
Philippines,Northern Mariana Islands,12836,12905,13757,15233,12330,11045,11150,-1686,-0.1313493300093487,921,0.06694773569819001,-1180,-0.09570154095701541,105,0.009506564056133997,PHL,MNP,77958223,94636700,103031365,112190977,80338,54087,51514,49587,9.938410644200022,22485.73214753867
Thailand,Finland,411,960,1509,4256,6108,8884,11110,10699,26.0316301703163,1098,0.7276341948310139,5002,0.8189259986902423,2226,0.2505628095452499,THA,FIN,63066603,68270489,70294397,71475664,5176209,5363352,5479531,5529543,15.543752066437605,200.92076325294875
United Kingdom,India,5063,5508,5952,9732,12622,11761,10999,5936,1.172427414576338,889,0.14936155913978494,-1623,-0.1285850102994771,-762,-0.06479040897882833,GBR,IND,58892514,62766365,65116219,67081234,1059633675,1240613620,1322866505,1396387127,16.39653796470113,0.7876755512370175
South Korea,Brazil,0,0,0,4251,8505,10025,10891,10891,1,0,0,2386,0.2805408583186361,866,0.08638403990024937,KOR,BRA,47008111,49554112,51014947,51836239,175873720,196353492,205188205,213196304,21.010397764390273,5.108437527134616
India,Sri Lanka,39329,35506,31618,24499,10529,10658,10837,-28492,-0.7244526939408579,-7711,-0.24388006831551648,308,0.02925254060214645,179,0.016794895852880465,IND,LKA,1059633675,1240613620,1322866505,1396387127,18776371,20668557,21336697,21919000,0.7760741839035874,49.441124138874954
Sri Lanka,Singapore,5788,5078,4860,6850,9222,10587,10767,4979,0.8602280580511403,-928,-0.19094650205761318,1545,0.1675341574495771,180,0.01700198356474922,LKA,SGP,18776371,20668557,21336697,21919000,4027887,5076732,5535002,5685807,49.12176650394635,189.36625882658348
Indonesia,United Kingdom,938,3687,6499,7530,7949,9513,10737,9799,10.446695095948828,5561,0.8556701030927835,2788,0.35073594162787775,1224,0.12866603595080417,IDN,GBR,214072421,244016173,259091970,271857970,58892514,62766365,65116219,67081234,3.9494887716552873,16.005966735793802
Pakistan,South Korea,269,1674,3612,4744,7750,4429,10720,10451,38.85130111524163,3343,0.9255260243632336,2970,0.3832258064516129,6291,1.4204109279747121,PAK,KOR,154369924,194454498,210969298,227196741,47008111,49554112,51014947,51836239,4.718377540459526,20.68051272006829
North Korea,Russian Federation,9699,9245,8456,9538,10425,10624,10617,918,0.09464893287967832,-1243,-0.146996215704825,192,0.01841726618705036,-7,-6.588855421686747e-4,PRK,RUS,23367059,24686435,25258015,25867467,146596869,142849468,144640716,145245148,41.04383316696606,7.309710614223064
Sri Lanka,Netherlands,4699,6813,9156,10188,9933,10210,10610,5911,1.2579272185571397,4457,0.48678462210572304,677,0.06815664955199839,400,0.039177277179236046,LKA,NLD,18776371,20668557,21336697,21919000,15925513,16615394,16939923,17441500,48.405492951320774,60.83192385975977
Pakistan,Ireland,293,1594,3770,6971,9025,9219,10570,10277,35.075085324232084,3477,0.9222811671087533,1545,0.17119113573407202,1351,0.14654517843583903,PAK,IRL,154369924,194454498,210969298,227196741,3805174,4560155,4701957,4985382,4.6523554666657825,212.01986126639844
Timor-Leste,Australia,9518,4904,0,10709,10580,10000,10555,1037,0.10895146039083842,-9518,1,-25,-0.0023629489603024575,555,0.0555,TLS,AUS,878360,1088486,1205813,1299995,19028802,22031750,23815995,25649248,811.9261997161528,41.15130392906646
Malaysia,Japan,4684,5428,8387,7889,8364,8738,10519,5835,1.245730145175064,3703,0.4415166328842256,2155,0.2576518412242946,1781,0.20382238498512245,MYS,JPN,22945150,28717731,31068833,33199993,126843000,128070000,127141000,126261000,31.683741620066,8.331155305280332
Peru,China,557,2147,4267,6168,7792,9612,10455,9898,17.770197486535007,3710,0.8694633231778768,2663,0.3417607802874743,843,0.08770287141073659,PER,CHN,26654439,29229572,30711863,33304756,1262645000,1337705000,1379860000,1411100000,31.391912914780097,0.740911345758628
Vietnam,Denmark,5087,6865,8651,9215,9448,9781,10384,5297,1.041281698447022,3564,0.41197549416252455,936,0.09906858594411516,603,0.06165013802269707,VNM,DNK,79001142,87411012,92191398,96648685,5339616,5547683,5683483,5831404,10.744067547323587,178.07032405918025
India,Greece,5351,6117,6983,8679,10751,10130,10353,5002,0.9347785460661558,1632,0.23371043963912358,-398,-0.03701981211050135,223,0.022013820335636723,IND,GRC,1059633675,1240613620,1322866505,1396387127,10805808,11121341,10820883,10698599,0.7414133086605001,96.76967984312712
Thailand,Bangladesh,15503,11945,8386,9181,10259,10548,10343,-5160,-0.33283880539250466,-7117,-0.8486763653708562,84,0.008187932547031875,-205,-0.01943496397421312,THA,BGD,63066603,68270489,70294397,71475664,129193327,148391139,157830000,167420951,14.47065955203998,6.177840908334107
Singapore,Hong Kong,6619,7388,8156,8905,9675,9887,10309,3690,0.5574860250793171,1537,0.1884502206964198,634,0.0655297157622739,422,0.0426823101041772,SGP,HKG,4027887,5076732,5535002,5685807,6665000,7024200,7291300,7481000,181.31111379615945,137.80243282983557
Bangladesh,Sweden,2307,2738,2937,3882,5480,6839,10263,7956,3.448634590377113,630,0.21450459652706844,4783,0.8728102189781022,3424,0.5006579909343472,BGD,SWE,129193327,148391139,157830000,167420951,8872109,9378126,9799186,10353442,6.130057163514738,99.12645475775109
Thailand,Belgium,3947,3922,3782,5685,7190,8668,9955,6008,1.52216873574867,-165,-0.04362771020624009,2765,0.38456189151599446,1287,0.1484771573604061,THA,BEL,63066603,68270489,70294397,71475664,10251250,10895586,11274196,11538604,13.92781744566934,86.27560145057409
Sri Lanka,Cyprus,2457,3474,4491,6752,10361,9514,9821,7364,2.9971509971509973,2034,0.4529058116232465,-540,-0.052118521378245346,307,0.03226823628337187,LKA,CYP,18776371,20668557,21336697,21919000,948237,1129686,1187280,1237537,44.80587618048269,793.5924340039934
Vietnam,New Zealand,3076,3371,3841,4662,5572,6393,9742,6666,2.1671001300390116,765,0.19916688362405624,4170,0.7483847810480976,3349,0.523854215548256,VNM,NZL,79001142,87411012,92191398,96648685,3857700,4350700,4609400,5090200,10.079806052198228,191.38737181250244
Nepal,Hong Kong,6254,6980,7706,8413,9141,9342,9741,3487,0.5575631595778702,1452,0.18842460420451596,600,0.06563833278634723,399,0.04271034039820167,NPL,HKG,24559500,27161567,27610325,29348627,6665000,7024200,7291300,7481000,33.19064977043049,130.20986499131132
China,Mexico,1240,1911,2665,4698,7274,8849,9706,8466,6.827419354838709,1425,0.5347091932457786,2432,0.3343414902392081,857,0.09684710136738614,CHN,MEX,1262645000,1337705000,1379860000,1411100000,97873442,112532401,120149897,125998302,0.6878321876550209,7.703278414021801
Sri Lanka,Norway,4707,6122,7295,8157,8714,9187,9531,4824,1.0248565965583174,2588,0.35476353666895133,817,0.0937571723663071,344,0.037444214651137474,LKA,NOR,18776371,20668557,21336697,21919000,4490967,4889252,5188607,5379475,43.48282312149277,177.17342305708272
Australia,Hong Kong,6092,6799,7506,8195,8903,9098,9486,3394,0.557124097176625,1414,0.18838262723154808,583,0.06548354487251488,388,0.042646735546273906,AUS,HKG,19028802,22031750,23815995,25649248,6665000,7024200,7291300,7481000,36.98354041412832,126.80122978211469
Bhutan,India,11088,9610,8131,9661,10831,10092,9438,-1650,-0.1488095238095238,-2957,-0.36366990530070104,-1393,-0.12861231649893823,-654,-0.06480380499405469,BTN,IND,587207,705516,743274,772506,1059633675,1240613620,1322866505,1396387127,1221.7380835877002,0.675887067240201
Singapore,Bangladesh,10556,9063,7569,8316,9307,9583,9396,-1160,-0.10989010989010989,-2987,-0.3946360153256705,89,0.00956269474589019,-187,-0.01951372221642492,SGP,BGD,4027887,5076732,5535002,5685807,129193327,148391139,157830000,167420951,165.253586694026,5.612200829034832
India,Thailand,3389,5665,9112,8371,8232,8832,9245,5856,1.7279433461197993,5723,0.6280728709394205,1013,0.12305636540330418,413,0.04676177536231884,IND,THA,1059633675,1240613620,1322866505,1396387127,63066603,68270489,70294397,71475664,0.6620656851701269,12.93447235411482
Australia,Papua New Guinea,13916,14258,10675,10675,9056,9183,9219,-4697,-0.3375251509054326,-3241,-0.30360655737704917,163,0.01799911660777385,36,0.003920287487749101,AUS,PNG,19028802,22031750,23815995,25649248,5508297,7583269,8682174,9749640,35.942574222838815,94.55733750169237
India,Portugal,1939,4184,6600,7355,6889,7809,8957,7018,3.6193914388860238,4661,0.7062121212121212,2068,0.30018870663376396,1148,0.14700986041746703,IND,PRT,1059633675,1240613620,1322866505,1396387127,10289898,10573100,10358076,10297081,0.6414410321329179,86.98581666008066
South Korea,Denmark,6527,7400,8273,8490,8345,8548,8940,2413,0.36969511260916194,1746,0.21104798742898587,595,0.0713001797483523,392,0.045858680393074405,KOR,DNK,47008111,49554112,51014947,51836239,5339616,5547683,5683483,5831404,17.246621615430087,153.3078483329229
Myanmar,Canada,2337,2995,3724,5703,8080,8164,8845,6508,2.7847667950363713,1387,0.37244897959183676,765,0.09467821782178218,681,0.08341499265066143,MMR,CAN,45538332,49390988,51483949,53423198,30685730,34005902,35704498,38028638,16.556477955512886,23.25878723292693
Pakistan,Greece,5947,8295,10780,21381,33141,31230,8823,2876,0.48360517908189005,4833,0.44833024118738407,-24318,-0.7337738752602516,-22407,-0.7174831892411143,PAK,GRC,154369924,194454498,210969298,227196741,10805808,11121341,10820883,10698599,3.883418380547985,82.46874193527582
South Korea,Netherlands,4145,4521,5056,5864,6392,7124,8782,4637,1.1186972255729795,911,0.18018196202531644,2390,0.3739048811013767,1658,0.23273441886580573,KOR,NLD,47008111,49554112,51014947,51836239,15925513,16615394,16939923,17441500,16.941815551085796,50.351173924261104
India,Mauritius,515,1483,3278,5252,7517,8651,8778,8263,16.044660194174757,2763,0.8428920073215376,1261,0.16775309298922442,127,0.014680383770662352,IND,MUS,1059633675,1240613620,1322866505,1396387127,1186873,1250400,1262879,1266014,0.6286222373632637,693.357261452085
Vietnam,Finland,1645,2035,2424,3535,4251,5754,8677,7032,4.274772036474164,779,0.32136963696369636,4426,1.0411667842860504,2923,0.507994438651373,VNM,FIN,79001142,87411012,92191398,96648685,5176209,5363352,5479531,5529543,8.977876936452887,156.92074372149742
Pakistan,Indonesia,5486,3629,1773,4457,7428,8223,8645,3159,0.5758293838862559,-3713,-2.0941906373378454,1217,0.16383952611739364,422,0.05131946977988568,PAK,IDN,154369924,194454498,210969298,227196741,214072421,244016173,259091970,271857970,3.805072186312743,3.1799693052957028
Philippines,Greece,11217,8569,6061,7359,8970,8452,8638,-2579,-0.22991887313898546,-5156,-0.8506847054941429,-332,-0.03701226309921962,186,0.022006625650733556,PHL,GRC,77958223,94636700,103031365,112190977,10805808,11121341,10820883,10698599,7.699371403103122,80.73954356079707
Vietnam,Belgium,2690,3562,4325,6840,7904,8206,8596,5906,2.195539033457249,1635,0.37803468208092483,692,0.08755060728744939,390,0.04752620034121375,VNM,BEL,79001142,87411012,92191398,96648685,10251250,10895586,11274196,11538604,8.894068243142677,74.49774686781868
Japan,Thailand,10091,9092,9971,8458,7553,8103,8481,-1610,-0.15954811217916956,-120,-0.012034901213519206,928,0.1228650867205084,378,0.04664938911514254,JPN,THA,126843000,128070000,127141000,126261000,63066603,68270489,70294397,71475664,6.717038515456078,11.865577072498409
Malaysia,Libya,6980,6351,5828,6425,7051,7894,8454,1474,0.21117478510028653,-1152,-0.19766643788606725,1403,0.19897886824563893,560,0.0709399543957436,MYS,LBY,22945150,28717731,31068833,33199993,5154790,6491988,6192235,6653942,25.463860790573058,127.05250511651589
Bangladesh,Mauritius,71,150,313,3672,7235,8327,8415,8344,117.52112676056338,242,0.7731629392971247,1180,0.1630960608154803,88,0.010568031704095112,BGD,MUS,129193327,148391139,157830000,167420951,1186873,1250400,1262879,1266014,5.0262526581873255,664.6845927454199
Bangladesh,Vietnam,225,523,1244,4129,6540,7895,8325,8100,36,1019,0.8191318327974276,1785,0.27293577981651373,430,0.05446485117162761,BGD,VNM,129193327,148391139,157830000,167420951,79001142,87411012,92191398,96648685,4.9724959452655355,8.613671256882595
Indonesia,Vietnam,793,2197,5662,5861,6511,7860,8288,7495,9.451450189155107,4869,0.8599434828682444,1777,0.27292274612194745,428,0.0544529262086514,IDN,VNM,214072421,244016173,259091970,271857970,79001142,87411012,92191398,96648685,3.048650734793613,8.575388273518673
South Korea,Argentina,10229,9078,7927,7498,7066,8154,8232,-1997,-0.19522925017108222,-2302,-0.29039989907909675,1166,0.16501556750636853,78,0.009565857247976454,KOR,ARG,47008111,49554112,51014947,51836239,37070774,40788453,43131966,45376763,15.88078178279871,18.14144389276952
Afghanistan,United Arab Emirates,1630,2088,2668,3208,6878,7515,8191,6561,4.0251533742331285,1038,0.38905547226386805,1313,0.19089851701075894,676,0.08995342648037259,AFG,ARE,19542982,28189672,33753499,38972230,3275333,8481771,8916899,9287289,21.01752966150513,88.19581257781469
Iran,Armenia,9654,10242,11205,7413,6172,8135,8097,-1557,-0.1612802983219391,1551,0.13842034805890227,1925,0.31189241736876216,-38,-0.004671173939766442,IRN,ARM,65544383,75373855,81790841,87290193,3168523,2946293,2878595,2805608,9.275956120294063,288.6005457640554
Sri Lanka,Denmark,5014,6510,8005,7994,7653,7767,8054,3040,0.6063023534104507,2991,0.3736414740787008,401,0.05239775251535345,287,0.03695120381099524,LKA,DNK,18776371,20668557,21336697,21919000,5339616,5547683,5683483,5831404,36.74437702449929,138.11425173080102
Sri Lanka,Thailand,3781,6348,10226,8375,7126,7645,8002,4221,1.11637133033589,6445,0.6302562096616467,876,0.1229301150715689,357,0.04669718770438195,LKA,THA,18776371,20668557,21336697,21919000,63066603,68270489,70294397,71475664,36.50713992426662,11.195418905097544
Iran,Spain,1771,2159,3477,4212,4920,5888,7947,6176,3.48729531338227,1706,0.4906528616623526,3027,0.6152439024390244,2059,0.34969429347826086,IRN,ESP,65544383,75373855,81790841,87290193,40567864,46576897,46444832,47365655,9.104115510433113,16.777979740805865
Bhutan,Australia,25,33,70,130,1690,5850,7937,7912,316.48,45,0.6428571428571429,6247,3.6964497041420117,2087,0.35675213675213674,BTN,AUS,587207,705516,743274,772506,19028802,22031750,23815995,25649248,1027.4353856151279,30.944377004737138
Cambodia,New Zealand,4114,3575,4643,5600,6263,6826,7931,3817,0.9278074866310161,529,0.11393495584751238,1668,0.26632604183298736,1105,0.16188104307061235,KHM,NZL,12118841,14363532,15417523,16396860,3857700,4350700,4609400,5090200,48.369016994717285,155.80920199599228
Pakistan,Hong Kong,5062,5650,6237,6809,7398,7560,7882,2820,0.5570920584749111,1175,0.1883918550585217,484,0.06542308732089754,322,0.04259259259259259,PAK,HKG,154369924,194454498,210969298,227196741,6665000,7024200,7291300,7481000,3.4692399042819018,105.36024595642294
South Korea,Norway,4821,5355,5966,6514,7056,7413,7832,3011,0.6245592200788218,1145,0.19192088501508547,776,0.10997732426303855,419,0.05652232564413868,KOR,NOR,47008111,49554112,51014947,51836239,4490967,4889252,5188607,5379475,15.109120860408101,145.59041542157925
Mongolia,Czechia,140,210,279,2887,5209,4607,7831,7691,54.93571428571428,139,0.4982078853046595,2622,0.5033595699750432,3224,0.6998046451052746,MNG,CZE,2450979,2702520,2964749,3294335,10255063,10474410,10546059,10697858,237.71110102645906,73.20156988436378
Kenya,India,8170,5541,2912,6291,8874,8268,7733,-437,-0.053488372093023255,-5258,-1.8056318681318682,-1141,-0.1285778679287807,-535,-0.06470730527334301,KEN,IND,30851606,41517895,46851488,51985780,1059633675,1240613620,1322866505,1396387127,14.87522164715043,0.5537862567247801
Sri Lanka,Malaysia,1194,1366,1927,4186,5960,7260,7693,6499,5.443048576214405,733,0.38038401660612353,1733,0.29077181208053693,433,0.05964187327823692,LKA,MYS,18776371,20668557,21336697,21919000,22945150,28717731,31068833,33199993,35.09740407865323,23.171691632585585
Singapore,India,9307,7240,5173,7228,8799,8199,7668,-1639,-0.1761040077361126,-4134,-0.7991494297312971,-1131,-0.12853733378793045,-531,-0.06476399560922064,SGP,IND,4027887,5076732,5535002,5685807,1059633675,1240613620,1322866505,1396387127,134.862122474435,0.5491313871156878
Iran,Finland,558,1160,1762,3019,3924,5589,7611,7053,12.63978494623656,1204,0.6833144154370034,3687,0.9396024464831805,2022,0.36178207192699946,IRN,FIN,65544383,75373855,81790841,87290193,5176209,5363352,5479531,5529543,8.719192544344587,137.6424778684242
Sri Lanka,Sweden,4599,5458,5854,6161,6627,6656,7487,2888,0.6279626005653403,1255,0.21438332763922105,860,0.1297721442583371,831,0.12484975961538461,LKA,SWE,18776371,20668557,21336697,21919000,8872109,9378126,9799186,10353442,34.15758018157763,72.31411544102917
Indonesia,New Zealand,2024,2641,3689,4412,4796,5105,7481,5457,2.6961462450592886,1665,0.451341827053402,2685,0.5598415346121768,2376,0.4654260528893242,IDN,NZL,214072421,244016173,259091970,271857970,3857700,4350700,4609400,5090200,2.7518045544149397,146.96868492397155
Sri Lanka,Maldives,4289,6212,7720,6929,6850,6772,7383,3094,0.7213802751224061,3431,0.4444300518134715,533,0.07781021897810218,611,0.09022445363260484,LKA,MDV,18776371,20668557,21336697,21919000,282507,361575,435582,514438,33.68310598111228,1435.1583669946622
South Korea,Philippines,593,798,1827,1478,6799,6906,7350,6757,11.39460370994941,1234,0.675424192665572,551,0.0810413296072952,444,0.06429192006950478,KOR,PHL,47008111,49554112,51014947,51836239,77958223,94636700,103031365,112190977,14.179269448927418,6.551328989674454
Laos,Vietnam,1033,1889,3994,4941,5981,6956,7334,6301,6.099709583736689,2961,0.7413620430645969,1353,0.2262163517806387,378,0.054341575618171364,LAO,VNM,5430853,6323418,6787419,7319399,79001142,87411012,92191398,96648685,100.19948359148067,7.588308107865099
Vietnam,Thailand,18879,12336,8340,7172,6519,6994,7322,-11557,-0.6121616611049314,-10539,-1.2636690647482014,803,0.1231784015953367,328,0.046897340577637975,VNM,THA,79001142,87411012,92191398,96648685,63066603,68270489,70294397,71475664,7.575892005152475,10.244046141355188
Netherlands,Indonesia,928,614,300,3187,6279,6950,7306,6378,6.872844827586207,-628,-2.0933333333333333,1027,0.16356107660455488,356,0.05122302158273381,NLD,IDN,15925513,16615394,16939923,17441500,214072421,244016173,259091970,271857970,41.88859903104664,2.6874327061296017
Philippines,Cyprus,1793,2535,3277,4927,7560,6941,7165,5372,2.996095928611266,1484,0.4528532194079951,-395,-0.052248677248677246,224,0.03227200691543005,PHL,CYP,77958223,94636700,103031365,112190977,948237,1129686,1187280,1237537,6.386431593335709,578.9725882943299
India,United Republic of Tanzania,4968,6308,6642,7198,7629,8010,7135,2167,0.4361916264090177,1674,0.25203252032520324,-494,-0.0647529165028182,-875,-0.10923845193508115,IND,TZA,1059633675,1240613620,1322866505,1396387127,34463704,45110527,52542823,61704518,0.5109614563211309,11.56317273234352
United Kingdom,China,1198,2036,2883,4168,5264,6493,7061,5863,4.893989983305509,1685,0.584460631286854,1797,0.34137537993920974,568,0.08747882334822116,GBR,CHN,58892514,62766365,65116219,67081234,1262645000,1337705000,1379860000,1411100000,10.526043692040608,0.5003897668485578
Brunei Darussalam,Malaysia,3234,2956,3425,4589,5460,6657,7054,3820,1.181199752628324,191,0.055766423357664234,1594,0.29194139194139196,397,0.059636472885684244,BRN,MYS,333926,396053,421437,441725,22945150,28717731,31068833,33199993,1596.9211613560474,21.24699243159479
Afghanistan,Finland,4,144,284,1604,2342,4623,7019,7015,1753.75,280,0.9859154929577465,4677,1.997011101622545,2396,0.518278174345663,AFG,FIN,19542982,28189672,33753499,38972230,5176209,5363352,5479531,5529543,18.01026012624887,126.9363489894192
India,Finland,549,768,986,2545,3624,5159,6954,6405,11.666666666666666,437,0.4432048681541582,3330,0.9188741721854304,1795,0.34793564644310915,IND,FIN,1059633675,1240613620,1322866505,1396387127,5176209,5363352,5479531,5529543,0.4979994347942739,125.76084497398791
India,China,1137,1975,2839,4103,5183,6393,6953,5816,5.1152154793315745,1702,0.5995068686157098,1770,0.3415010611614895,560,0.08759580791490693,IND,CHN,1059633675,1240613620,1322866505,1396387127,1262645000,1337705000,1379860000,1411100000,0.4979278214156725,0.49273616327687625
China,South Africa,8690,8051,9841,12947,10396,7845,6914,-1776,-0.2043728423475259,1151,0.1169596585712834,-3482,-0.33493651404386304,-931,-0.11867431485022308,CHN,ZAF,1262645000,1337705000,1379860000,1411100000,46813266,51784921,55876504,58801927,0.48997236198710226,11.758118063035587
Nepal,Germany,867,1386,1905,2600,3160,3243,6844,5977,6.893886966551326,1038,0.5448818897637795,3684,1.1658227848101266,3601,1.110391612704286,NPL,DEU,24559500,27161567,27610325,29348627,82211508,81776930,81686611,83160871,23.319659894140877,8.229832032423037
Malaysia,Germany,2616,3016,3415,4267,4945,5075,6810,4194,1.603211009174312,799,0.23396778916544655,1865,0.37714863498483314,1735,0.341871921182266,MYS,DEU,22945150,28717731,31068833,33199993,82211508,81776930,81686611,83160871,20.512052517601436,8.188947419754658
Indonesia,Brunei Darussalam,3324,4551,5778,5907,6036,6165,6717,3393,1.0207581227436824,2454,0.42471443406022846,681,0.11282306163021869,552,0.08953771289537713,IDN,BRN,214072421,244016173,259091970,271857970,333926,396053,421437,441725,2.4707754567578064,1520.6293508404551
Canada,China,950,1797,2731,3948,4987,6151,6691,5741,6.043157894736842,1781,0.6521420725009154,1704,0.3416883898135151,540,0.0877906031539587,CAN,CHN,30685730,34005902,35704498,38028638,1262645000,1337705000,1379860000,1411100000,17.594634864388254,0.4741690879455744
China,Ukraine,7924,7666,7502,6854,6539,6560,6668,-1256,-0.15850580514891469,-422,-0.05625166622234071,129,0.019727787123413366,108,0.016463414634146342,CHN,UKR,1262645000,1337705000,1379860000,1411100000,49176500,45870741,45167350,44207754,0.47253915385160516,15.083326784708401
Nepal,Portugal,9,20,32,272,468,530,6637,6628,736.4444444444445,23,0.71875,6169,13.181623931623932,6107,11.522641509433962,NPL,PRT,24559500,27161567,27610325,29348627,10289898,10573100,10358076,10297081,22.61434580909015,64.4551596709786
India,Seychelles,1276,1651,2026,3907,5788,6482,6628,5352,4.19435736677116,750,0.37018756169792694,840,0.14512785072563925,146,0.02252391237272447,IND,SYC,1059633675,1240613620,1322866505,1396387127,81131,89770,93419,98462,0.4746534733702111,6731.530945948691
China,Czechia,303,454,605,2714,4558,4807,6620,6317,20.848184818481847,302,0.4991735537190083,2062,0.45239139973672665,1813,0.3771583107967547,CHN,CZE,1262645000,1337705000,1379860000,1411100000,10255063,10474410,10546059,10697858,0.46913755226419107,61.88154675449982
China,Romania,605,1331,2100,2101,2695,3722,6544,5939,9.816528925619835,1495,0.7119047619047619,3849,1.428200371057514,2822,0.7581945190757657,CHN,ROU,1262645000,1337705000,1379860000,1411100000,22442971,20246871,19815616,19265250,0.4637516830841188,33.967895563255084
Fiji,United Kingdom,483,1900,3349,4488,4737,5669,6397,5914,12.244306418219463,2866,0.8557778441325768,1660,0.3504327633523327,728,0.1284177103545599,FJI,GBR,832509,905169,917200,920422,58892514,62766365,65116219,67081234,695.0072901343079,9.53619905084036
Thailand,Austria,3088,3484,3879,4301,4776,5369,6244,3156,1.0220207253886011,791,0.20391853570507862,1468,0.3073701842546064,875,0.16297262059973924,THA,AUT,63066603,68270489,70294397,71475664,8011566,8363404,8642699,8916864,8.735840495304808,70.02461852059199
India,South Korea,136,849,1833,2611,4422,4505,6172,6036,44.38235294117647,1697,0.9258046917621385,1750,0.39574853007688826,1667,0.3700332963374029,IND,KOR,1059633675,1240613620,1322866505,1396387127,47008111,49554112,51014947,51836239,0.44199777272796353,11.906728032487079
Australia,Malaysia,1851,2118,2989,4005,4766,5811,6157,4306,2.3263101026472177,1138,0.3807293409166945,1391,0.29185900125891734,346,0.05954224746171055,AUS,MYS,19028802,22031750,23815995,25649248,22945150,28717731,31068833,33199993,24.004602396140427,18.545184633020856
North Korea,Philippines,1321,1777,6033,4883,5665,5753,6123,4802,3.6351249053747163,4712,0.7810376263881983,458,0.08084730803177405,370,0.06431427081522684,PRK,PHL,23367059,24686435,25258015,25867467,77958223,94636700,103031365,112190977,23.670659365294636,5.457658150173699
Pakistan,Austria,2651,2991,3331,3694,4102,4985,6097,3446,1.2998868351565447,680,0.204142900030021,1995,0.4863481228668942,1112,0.2230692076228686,PAK,AUT,154369924,194454498,210969298,227196741,8011566,8363404,8642699,8916864,2.6835772261363555,68.37605687380676
Vietnam,Italy,636,1327,2017,3637,4973,5276,6077,5441,8.55503144654088,1381,0.6846802181457611,1104,0.22199879348481802,801,0.15181956027293403,VNM,ITA,79001142,87411012,92191398,96648685,56942108,59277417,60730582,59438851,6.28772134871778,10.223952680377351
India,Jordan,871,2572,4273,4622,11113,4587,5945,5074,5.82548794489093,3402,0.796161947109759,-5168,-0.46504094303968324,1358,0.2960540658382385,IND,JOR,1059633675,1240613620,1322866505,1396387127,5056174,6931258,9494246,10928721,0.42574153578544127,54.39794830520424
Canada,Philippines,628,845,1872,1515,5480,5565,5922,5294,8.429936305732484,1244,0.6645299145299145,442,0.08065693430656934,357,0.06415094339622641,CAN,PHL,30685730,34005902,35704498,38028638,77958223,94636700,103031365,112190977,15.572474617681548,5.278499357394846
Pakistan,New Zealand,28,90,1283,2114,2558,2961,5899,5871,209.67857142857142,1255,0.9781761496492596,3341,1.3060985144644253,2938,0.9922323539344816,PAK,NZL,154369924,194454498,210969298,227196741,3857700,4350700,4609400,5090200,2.596428088728614,115.88935601744528
United Kingdom,South Korea,559,855,1425,2199,3842,3818,5848,5289,9.461538461538462,866,0.607719298245614,2006,0.5221238938053098,2030,0.5316919853326348,GBR,KOR,58892514,62766365,65116219,67081234,47008111,49554112,51014947,51836239,8.717788345992561,11.281682685350686
Nepal,Brunei Darussalam,3665,4337,5008,5120,5232,5344,5822,2157,0.5885402455661665,1343,0.2681709265175719,590,0.11276758409785932,478,0.08944610778443114,NPL,BRN,24559500,27161567,27610325,29348627,333926,396053,421437,441725,19.837384556354206,1318.0146018450394
India,Zambia,4284,3854,3468,4007,4630,4078,5709,1425,0.3326330532212885,-816,-0.23529411764705882,1079,0.2330453563714903,1631,0.3999509563511525,IND,ZMB,1059633675,1240613620,1322866505,1396387127,9891136,13792086,16248230,18927715,0.4088407784355062,30.162119410610313
India,Russian Federation,9801,8083,6072,5893,5594,5701,5696,-4105,-0.4188348127742067,-3729,-0.6141304347826086,102,0.018233821952091528,-5,-8.770391159445711e-4,IND,RUS,1059633675,1240613620,1322866505,1396387127,146596869,142849468,144640716,145245148,0.40790980451368775,3.921645630461956
Indonesia,France,3852,3977,4101,4242,4644,5147,5658,1806,0.4688473520249221,249,0.06071689831748354,1014,0.21834625322997417,511,0.09928113464153876,IDN,FRA,214072421,244016173,259091970,271857970,60921384,65030575,66548272,67571107,2.081233814848246,8.373401371091937
South Korea,Spain,1257,1496,2379,2975,3641,4189,5654,4397,3.498011137629276,1122,0.47162673392181587,2013,0.552870090634441,1465,0.3497254714729052,KOR,ESP,47008111,49554112,51014947,51836239,40567864,46576897,46444832,47365655,10.907427137991242,11.936919271991489
India,Botswana,1967,2375,3032,3936,4863,5282,5650,3683,1.8723945094051855,1065,0.3512532981530343,787,0.16183425868805265,368,0.06967057932601288,IND,BWA,1059633675,1240613620,1322866505,1396387127,1726985,2091664,2305171,2546402,0.4046155890980224,221.88169817648588
Australia,South Korea,315,631,1148,2155,4016,3542,5604,5289,16.79047619047619,833,0.725609756097561,1588,0.3954183266932271,2062,0.5821569734613213,AUS,KOR,19028802,22031750,23815995,25649248,47008111,49554112,51014947,51836239,21.848593767739313,10.810969522692416
South Korea,North Korea,5873,5201,4528,4697,4866,5358,5477,-396,-0.06742720926272773,-1345,-0.29704063604240283,611,0.1255651459103987,119,0.022209779768570363,KOR,PRK,47008111,49554112,51014947,51836239,23367059,24686435,25258015,25867467,10.565967179833397,21.173313954551485
Russian Federation,South Korea,37,1266,2899,2710,3594,3125,5472,5435,146.8918918918919,2862,0.9872369782683684,1878,0.5225375626043406,2347,0.75104,RUS,KOR,146596869,142849468,144640716,145245148,47008111,49554112,51014947,51836239,3.7674236112864854,10.556321418303515
China,Suriname,2055,2538,3135,3836,4526,4915,5446,3391,1.6501216545012165,1080,0.3444976076555024,920,0.20326999558108705,531,0.10803662258392675,CHN,SUR,1262645000,1337705000,1379860000,1411100000,478998,546080,575475,607065,0.38594004677202187,897.1032755965176
Iran,Japan,1237,8764,6167,4566,4841,4359,5411,4174,3.37429264349232,4930,0.7994162477703908,570,0.11774426771328238,1052,0.24133975682495987,IRN,JPN,65544383,75373855,81790841,87290193,126843000,128070000,127141000,126261000,6.198863599717325,4.285567198105512
Bangladesh,Brazil,0,0,0,22,46,53,5384,5384,1,0,0,5338,116.04347826086956,5331,100.58490566037736,BGD,BRA,129193327,148391139,157830000,167420951,175873720,196353492,205188205,213196304,3.215846026343501,2.5253721096403248
India,Panama,1474,1738,2112,2696,3828,4481,5383,3909,2.6519674355495253,638,0.3020833333333333,1555,0.4062173458725183,902,0.20129435393885292,IND,PAN,1059633675,1240613620,1322866505,1396387127,3001731,3623617,3957099,4294396,0.3854948170114433,125.34940885749707
Pakistan,Switzerland,1918,2427,2946,3334,3889,4495,5381,3463,1.805526590198123,1028,0.34894772572980315,1492,0.38364618153767033,886,0.1971078976640712,PAK,CHE,154369924,194454498,210969298,227196741,7184250,7824909,8282396,8638167,2.368431860560887,62.29330829098349
Japan,China,1150,1706,2161,3123,3946,4866,5292,4142,3.6017391304347828,1011,0.46783896344285053,1346,0.3411049163710086,426,0.08754623921085081,JPN,CHN,126843000,128070000,127141000,126261000,1262645000,1337705000,1379860000,1411100000,4.191317984175636,0.37502657501240166
Vietnam,Hungary,653,1499,2345,2880,3440,3091,5272,4619,7.073506891271057,1692,0.7215351812366738,1832,0.5325581395348837,2181,0.7055968942089939,VNM,HUN,79001142,87411012,92191398,96648685,10210971,10000023,9843028,9750149,5.45480779174595,54.07096855648052
Italy,Sri Lanka,3,637,1273,2571,5236,5096,5168,5165,1721.6666666666667,1270,0.997643362136685,-68,-0.012987012987012988,72,0.0141287284144427,ITA,LKA,56942108,59277417,60730582,59438851,18776371,20668557,21336697,21919000,8.694649901627473,23.577717961585837
India,Libya,2288,2902,3564,3928,4310,4826,5167,2879,1.2583041958041958,1276,0.35802469135802467,857,0.1988399071925754,341,0.0706589307915458,IND,LBY,1059633675,1240613620,1322866505,1396387127,5154790,6491988,6192235,6653942,0.37002632723353657,77.65321669470518
Afghanistan,Russian Federation,19103,15576,11486,8328,4999,5095,5090,-14013,-0.7335497042349369,-7617,-0.6631551453943931,91,0.01820364072814563,-5,-9.813542688910696e-4,AFG,RUS,19542982,28189672,33753499,38972230,146596869,142849468,144640716,145245148,13.06058185533648,3.5044199892997456
South Korea,Hong Kong,3238,3614,3989,4355,4732,4836,5042,1804,0.5571340333539222,751,0.18826773627475557,310,0.06551141166525781,206,0.04259718775847808,KOR,HKG,47008111,49554112,51014947,51836239,6665000,7024200,7291300,7481000,9.726785926733612,67.39740676380163
Philippines,Finland,299,484,669,1315,1714,3090,4892,4593,15.361204013377927,370,0.5530642750373692,3178,1.85414235705951,1802,0.5831715210355987,PHL,FIN,77958223,94636700,103031365,112190977,5176209,5363352,5479531,5529543,4.360421961562916,88.47024066907518
Afghanistan,Ukraine,2552,2468,2416,2207,2605,4812,4891,2339,0.9165360501567398,-136,-0.056291390728476824,2286,0.8775431861804223,79,0.016417290108063174,AFG,UKR,19542982,28189672,33753499,38972230,49176500,45870741,45167350,44207754,12.549961857455939,11.063669961608998
Malaysia,Ireland,171,929,2197,3430,4098,4186,4798,4627,27.058479532163744,2026,0.9221665908056441,700,0.1708150317227916,612,0.14620162446249402,MYS,IRL,22945150,28717731,31068833,33199993,3805174,4560155,4701957,4985382,14.451810275984094,96.2413712730539
Azerbaijan,Iran,896,903,3046,7767,7349,5744,4788,3892,4.34375,2150,0.7058437294812869,-2561,-0.3484827867737107,-956,-0.16643454038997216,AZE,IRN,8048600,9054332,9649341,10093121,65544383,75373855,81790841,87290193,47.43825026966386,5.485152266761514
China,Botswana,874,1055,1348,2720,4111,4466,4777,3903,4.465675057208238,474,0.3516320474777448,666,0.16200437849671612,311,0.06963725929243171,CHN,BWA,1262645000,1337705000,1379860000,1411100000,1726985,2091664,2305171,2546402,0.33853022464743815,187.59803047594215
Malaysia,China,808,1372,1941,2805,3543,4370,4753,3945,4.882425742574258,1133,0.5837197320968572,1210,0.3415184871577759,383,0.08764302059496568,MYS,CHN,22945150,28717731,31068833,33199993,1262645000,1337705000,1379860000,1411100000,14.316268078731222,0.3368294238537311
Iran,New Zealand,394,732,1925,2671,2959,3201,4751,4357,11.058375634517766,1531,0.7953246753246753,1792,0.6056100033795201,1550,0.48422368009996875,IRN,NZL,65544383,75373855,81790841,87290193,3857700,4350700,4609400,5090200,5.442764916329146,93.3362146870457
Philippines,Libya,1929,2566,3246,3578,3926,4395,4707,2778,1.4401244167962675,1317,0.40573012939001846,781,0.1989302088639837,312,0.07098976109215017,PHL,LBY,77958223,94636700,103031365,112190977,5154790,6491988,6192235,6653942,4.195524565224171,70.74002147899697
Iran,Greece,2645,1946,1279,1613,2017,1900,4684,2039,0.7708884688090737,-1366,-1.0680218921032056,2667,1.3222607833415965,2784,1.4652631578947368,IRN,GRC,65544383,75373855,81790841,87290193,10805808,11121341,10820883,10698599,5.366009443924589,43.78143343815391
South Korea,Italy,630,2263,3896,3913,4683,3789,4607,3977,6.3126984126984125,3266,0.8382956878850103,-76,-0.016228913089899637,818,0.21588809712325152,KOR,ITA,47008111,49554112,51014947,51836239,56942108,59277417,60730582,59438851,8.887604673633826,7.750822774148175
South Korea,Belgium,271,229,174,1911,4208,4306,4589,4318,15.933579335793358,-97,-0.5574712643678161,381,0.09054182509505704,283,0.06572224802601022,KOR,BEL,47008111,49554112,51014947,51836239,10251250,10895586,11274196,11538604,8.85287993212625,39.77084229600045
Bhutan,Canada,0,17,35,1111,2210,4218,4569,4569,1,35,1,2359,1.067420814479638,351,0.08321479374110953,BTN,CAN,587207,705516,743274,772506,30685730,34005902,35704498,38028638,591.4517168798689,12.014629606245693
United Kingdom,Philippines,6028,8112,33603,27198,4217,4282,4556,-1472,-0.24419376244193763,27575,0.8206112549474749,339,0.08038890206307801,274,0.0639887902849136,GBR,PHL,58892514,62766365,65116219,67081234,77958223,94636700,103031365,112190977,6.791765339319787,4.060932636320655
Nepal,Denmark,37,78,118,816,1446,2644,4496,4459,120.51351351351352,81,0.6864406779661016,3050,2.1092669432918396,1852,0.7004538577912254,NPL,DNK,24559500,27161567,27610325,29348627,5339616,5547683,5683483,5831404,15.319285634724924,77.09978591776526
Tajikistan,Afghanistan,40537,36733,32929,28460,23991,15031,4422,-36115,-0.8909144731973259,-7608,-0.2310425460839989,-19569,-0.8156808803301238,-10609,-0.7058079968065997,TJK,AFG,6272998,7621779,8524063,9543207,19542982,28189672,33753499,38972230,46.33662457494635,11.346540857425916
India,Czechia,60,90,119,547,921,1707,4315,4255,70.91666666666667,59,0.4957983193277311,3394,3.6851248642779586,2608,1.527826596367897,IND,CZE,1059633675,1240613620,1322866505,1396387127,10255063,10474410,10546059,10697858,0.30901172866512683,40.33517737849951
China,Luxembourg,1017,966,927,804,691,1054,4295,3278,3.223205506391347,-90,-0.0970873786407767,3604,5.215629522431259,3241,3.0749525616698294,CHN,LUX,1262645000,1337705000,1379860000,1411100000,436300,506953,569604,630419,0.30437247537382184,681.2929178847719
Canada,India,6474,4242,2009,3637,4883,4550,4255,-2219,-0.3427556379363608,-4465,-2.222498755599801,-628,-0.12860946139668236,-295,-0.06483516483516484,CAN,IND,30685730,34005902,35704498,38028638,1059633675,1240613620,1322866505,1396387127,11.188936085483787,0.30471492594904165
Australia,Philippines,943,1269,2396,1939,3932,3993,4249,3306,3.505832449628844,1453,0.6064273789649416,317,0.0806205493387589,256,0.0641121963436013,AUS,PHL,19028802,22031750,23815995,25649248,77958223,94636700,103031365,112190977,16.565787815689568,3.7872920921260893
Nepal,Spain,45,67,119,680,2594,3136,4232,4187,93.04444444444445,74,0.6218487394957983,1638,0.6314572089437163,1096,0.3494897959183674,NPL,ESP,24559500,27161567,27610325,29348627,40567864,46576897,46444832,47365655,14.419754627703707,8.934743961632115
Philippines,Indonesia,3472,2297,1122,2305,3636,4025,4230,758,0.21831797235023043,-2350,-2.0944741532976825,594,0.16336633663366337,205,0.05093167701863354,PHL,IDN,77958223,94636700,103031365,112190977,214072421,244016173,259091970,271857970,3.7703566838534615,1.555959532839887
Sri Lanka,China,765,1251,1721,2487,3142,3875,4214,3449,4.508496732026144,956,0.5554909936083672,1072,0.3411839592616168,339,0.08748387096774193,LKA,CHN,18776371,20668557,21336697,21919000,1262645000,1337705000,1379860000,1411100000,19.225329622701768,0.2986322726950606
Mongolia,Sweden,30,36,39,122,496,2254,4212,4182,139.4,9,0.23076923076923078,3716,7.491935483870968,1958,0.8686779059449867,MNG,SWE,2450979,2702520,2964749,3294335,8872109,9378126,9799186,10353442,127.85584951135814,40.68212291139507
United States of America,Thailand,1640,2742,4411,3939,3750,4023,4211,2571,1.5676829268292682,2771,0.6282022217184312,461,0.12293333333333334,188,0.04673129505344271,USA,THA,282162411,309327143,320738994,331526933,63066603,68270489,70294397,71475664,1.2701833790378654,5.891515747233912
South Korea,Switzerland,1430,1894,2366,2698,3123,3727,4201,2771,1.9377622377622377,936,0.3956043956043956,1078,0.3451809157861031,474,0.12718003756372417,KOR,CHE,47008111,49554112,51014947,51836239,7184250,7824909,8282396,8638167,8.104368837407359,48.63300281182339
Cambodia,Japan,1171,1461,1761,2531,2683,3383,4199,3028,2.5858240819812126,590,0.33503691084611015,1516,0.5650391352963101,816,0.24120603015075376,KHM,JPN,12118841,14363532,15417523,16396860,126843000,128070000,127141000,126261000,25.60856163924068,3.325650834382747
Iran,Hungary,1800,1595,1389,1706,2037,1997,4125,2325,1.2916666666666667,-411,-0.2958963282937365,2088,1.0250368188512518,2128,1.0655983975963945,IRN,HUN,65544383,75373855,81790841,87290193,10210971,10000023,9843028,9750149,4.725616771176116,42.30704576924927
Indonesia,Timor-Leste,4485,4893,5337,5666,5779,4177,4113,-372,-0.08294314381270904,852,0.15964024732996066,-1666,-0.28828517044471363,-64,-0.015322001436437634,IDN,TLS,214072421,244016173,259091970,271857970,878360,1088486,1205813,1299995,1.5129223542719752,316.385832253201
Malaysia,Netherlands,2091,2362,2716,3067,3462,3555,4081,1990,0.9516977522716403,625,0.23011782032400588,619,0.17879838243789717,526,0.14796061884669479,MYS,NLD,22945150,28717731,31068833,33199993,15925513,16615394,16939923,17441500,12.292171266421652,23.398216896482527
Thailand,Kuwait,1823,1460,1666,1801,2388,3755,4073,2250,1.2342292923752056,-157,-0.09423769507803122,1685,0.7056113902847572,318,0.08468708388814913,THA,KWT,63066603,68270489,70294397,71475664,1934901,2943356,3908743,4360444,5.698443039297963,93.40791901008247
Australia,China,611,1114,1655,2392,3021,3726,4052,3441,5.631751227495909,1044,0.6308157099697885,1031,0.34127772260840783,326,0.08749329039184112,AUS,CHN,19028802,22031750,23815995,25649248,1262645000,1337705000,1379860000,1411100000,15.797734109007795,0.2871518673375381
China,Mali,301,190,76,309,2795,3439,4035,3734,12.40531561461794,-225,-2.960526315789474,1240,0.44364937388193204,596,0.17330619366094796,CHN,MLI,1262645000,1337705000,1379860000,1411100000,11239101,15529181,18112907,21224040,0.28594713344199557,19.011460589030175
Germany,Philippines,704,947,1638,1325,3727,3786,4029,3325,4.723011363636363,934,0.5702075702075702,302,0.08103031929165548,243,0.06418383518225039,DEU,PHL,82211508,81776930,81686611,83160871,77958223,94636700,103031365,112190977,4.8448266012028665,3.5911978910746094
Nepal,Belgium,59,50,38,760,1864,3529,4021,3962,67.15254237288136,-21,-0.5526315789473685,2157,1.1571888412017168,492,0.1394162652309436,NPL,BEL,24559500,27161567,27610325,29348627,10251250,10895586,11274196,11538604,13.700811284970843,34.84823640710783
Laos,Germany,2315,1709,1102,2089,2895,2972,3986,1671,0.7218142548596113,-1213,-1.100725952813067,1091,0.3768566493955095,1014,0.3411843876177658,LAO,DEU,5430853,6323418,6787419,7319399,82211508,81776930,81686611,83160871,54.458023124576215,4.793119591063446
South Korea,Malaysia,1194,1366,1927,2582,3073,3747,3970,2776,2.324958123953099,733,0.38038401660612353,897,0.2918971688903352,223,0.05951427808913798,KOR,MYS,47008111,49554112,51014947,51836239,22945150,28717731,31068833,33199993,7.658734654726783,11.957833846531232
Hong Kong,Costa Rica,1504,1604,2506,1643,3238,3285,3943,2439,1.6216755319148937,1002,0.39984038308060654,705,0.21772699197035206,658,0.20030441400304413,HKG,CRI,6665000,7024200,7291300,7481000,3979193,4622252,4895242,5123105,52.70685737200908,76.965043660046
China,Dominican Republic,3613,4013,4413,2916,1413,3776,3942,329,0.09106006089122613,800,0.1812825742125538,2529,1.7898089171974523,166,0.04396186440677966,CHN,DOM,1262645000,1337705000,1379860000,1411100000,8540791,9775755,10405832,10999664,0.27935653036638086,35.8374583078174
India,Ukraine,4609,4459,4364,3987,3804,3816,3879,-730,-0.15838576697765241,-245,-0.05614115490375802,75,0.01971608832807571,63,0.01650943396226415,IND,UKR,1059633675,1240613620,1322866505,1396387127,49176500,45870741,45167350,44207754,0.27778829559490775,8.7744787939238
Philippines,Jordan,2245,3455,4664,3501,7227,2983,3866,1621,0.7220489977728285,2419,0.5186535162950258,-3361,-0.46506157465061576,883,0.2960107274555816,PHL,JOR,77958223,94636700,103031365,112190977,5056174,6931258,9494246,10928721,3.4459099148410126,35.37467925112188
Mongolia,Australia,36,80,120,240,700,1780,3854,3818,106.05555555555556,84,0.7,3154,4.505714285714285,2074,1.1651685393258426,MNG,AUS,2450979,2702520,2964749,3294335,19028802,22031750,23815995,25649248,116.98870940569188,15.025781652545914
Australia,India,3116,1964,812,2845,4400,4099,3833,717,0.23010269576379974,-2304,-2.8374384236453203,-567,-0.12886363636363637,-266,-0.06489387655525738,AUS,IND,19028802,22031750,23815995,25649248,1059633675,1240613620,1322866505,1396387127,14.943907907163595,0.2744940801792425
Vanuatu,New Caledonia,3153,3654,4156,4427,4698,3611,3833,680,0.21566761814145258,1003,0.24133782483156882,-865,-0.1841209025117071,222,0.06147881473276101,VUT,NCL,192074,245453,276438,311685,213230,249750,269460,271080,1229.7672329435168,1413.9737346908662
Afghanistan,New Zealand,156,489,714,2051,2314,2540,3827,3671,23.53205128205128,558,0.7815126050420168,1513,0.6538461538461539,1287,0.5066929133858268,AFG,NZL,19542982,28189672,33753499,38972230,3857700,4350700,4609400,5090200,9.81981272305947,75.1836862991631
Nepal,New Zealand,72,229,335,553,1017,1465,3815,3743,51.986111111111114,263,0.7850746268656716,2798,2.751229105211406,2350,1.6040955631399318,NPL,NZL,24559500,27161567,27610325,29348627,3857700,4350700,4609400,5090200,12.998904514340655,74.94793917724255
Indonesia,Switzerland,2137,2316,2504,2780,3306,3518,3782,1645,0.7697707065980346,367,0.14656549520766773,476,0.14398064125831822,264,0.07504263786242182,IDN,CHE,214072421,244016173,259091970,271857970,7184250,7824909,8282396,8638167,1.3911676012294214,43.782436713714844
Indonesia,Italy,166,697,1227,2193,3122,3150,3734,3568,21.49397590361446,1061,0.8647106764466178,612,0.1960281870595772,584,0.1853968253968254,IDN,ITA,214072421,244016173,259091970,271857970,56942108,59277417,60730582,59438851,1.373511322842586,6.282086442081459
South Korea,Russian Federation,2014,2017,1948,2828,3651,3721,3718,1704,0.846077457795432,-66,-0.033880903490759756,67,0.018351136674883594,-3,-8.062348830959419e-4,KOR,RUS,47008111,49554112,51014947,51836239,146596869,142849468,144640716,145245148,7.1725882736207005,2.559810121849991
Bangladesh,Ireland,157,557,1264,2413,3164,3232,3706,3549,22.605095541401273,1107,0.8757911392405063,542,0.17130214917825537,474,0.14665841584158415,BGD,IRL,129193327,148391139,157830000,167420951,3805174,4560155,4701957,4985382,2.2135819787572464,74.3373326256644
Vietnam,Poland,2343,2003,1713,2268,2896,2757,3681,1338,0.5710627400768246,-630,-0.36777583187390545,785,0.2710635359116022,924,0.33514689880304677,VNM,POL,79001142,87411012,92191398,96648685,38258629,38042794,37986412,37899070,3.808639507097277,9.712639386665689
Cambodia,Laos,1398,1362,1197,1119,2273,3428,3667,2269,1.6230329041487839,-201,-0.16791979949874686,1394,0.6132864056313242,239,0.06971995332555427,KHM,LAO,12118841,14363532,15417523,16396860,5430853,6323418,6787419,7319399,22.364037992640057,50.099741795740336
Indonesia,Belgium,1692,1838,1928,2612,3251,3354,3598,1906,1.1264775413711583,236,0.12240663900414937,347,0.10673638880344509,244,0.0727489564698867,IDN,BEL,214072421,244016173,259091970,271857970,10251250,10895586,11274196,11538604,1.3234852007465516,31.18228166942899
Nepal,Finland,16,49,82,631,899,2298,3595,3579,223.6875,66,0.8048780487804879,2696,2.9988876529477198,1297,0.5644038294168843,NPL,FIN,24559500,27161567,27610325,29348627,5176209,5363352,5479531,5529543,12.249295341822975,65.01441439193077
Thailand,Laos,2277,2060,1648,1538,2415,3293,3522,1245,0.546772068511199,-629,-0.3816747572815534,1107,0.4583850931677019,229,0.06954145156392347,THA,LAO,63066603,68270489,70294397,71475664,5430853,6323418,6787419,7319399,4.927551285147907,48.118704828087665
Indonesia,Philippines,3752,5049,4711,3813,3253,3304,3515,-237,-0.06316631130063965,959,0.20356612184249628,262,0.08054103904088533,211,0.06386198547215496,IDN,PHL,214072421,244016173,259091970,271857970,77958223,94636700,103031365,112190977,1.2929545527026483,3.133050530436151
China,Greece,329,441,560,2015,3596,3388,3462,3133,9.522796352583587,231,0.4125,-134,-0.03726362625139043,74,0.021841794569067298,CHN,GRC,1262645000,1337705000,1379860000,1411100000,10805808,11121341,10820883,10698599,0.2453405144922401,32.35937714835372
Pakistan,China,460,899,1394,2015,2546,3140,3414,2954,6.421739130434783,934,0.6700143472022956,868,0.34092694422623726,274,0.08726114649681528,PAK,CHN,154369924,194454498,210969298,227196741,1262645000,1337705000,1379860000,1411100000,1.5026623995455992,0.241938912904826
Vietnam,Austria,1842,2078,2314,2566,2849,2856,3412,1570,0.8523344191096635,472,0.20397579948141745,563,0.19761319761319762,556,0.19467787114845939,VNM,AUT,79001142,87411012,92191398,96648685,8011566,8363404,8642699,8916864,3.5303118712892987,38.26457373354579
India,Brunei Darussalam,2595,2742,2889,2953,3017,3081,3357,762,0.29364161849710985,294,0.10176531671858775,340,0.11269472986410341,276,0.08958130477117819,IND,BRN,1059633675,1240613620,1322866505,1396387127,333926,396053,421437,441725,0.24040611196496658,759.9750976286151
United States of America,Vietnam,263,585,1359,1812,2625,3164,3335,3072,11.680608365019012,1096,0.8064753495217072,710,0.2704761904761905,171,0.05404551201011378,USA,VNM,282162411,309327143,320738994,331526933,79001142,87411012,92191398,96648685,1.0059514531207032,3.4506418788832978
Bangladesh,Austria,1508,1701,1894,2100,2332,2632,3326,1818,1.2055702917771882,386,0.20380147835269272,994,0.4262435677530017,694,0.26367781155015196,BGD,AUT,129193327,148391139,157830000,167420951,8011566,8363404,8642699,8916864,1.9866091908652461,37.30010909665102
North Korea,Germany,1277,1453,1628,2063,2409,2473,3316,2039,1.596711041503524,351,0.2156019656019656,907,0.37650477376504776,843,0.3408815204205419,PRK,DEU,23367059,24686435,25258015,25867467,82211508,81776930,81686611,83160871,12.819190993845666,3.9874522237748087
Somalia,Malaysia,51,121,233,588,1026,1510,3294,3243,63.588235294117645,182,0.7811158798283262,2268,2.210526315789474,1784,1.181456953642384,SOM,MYS,8721465,12026649,13763906,16537016,22945150,28717731,31068833,33199993,19.918950311229064,9.921688838910297
China,Libya,1366,1800,2264,2494,2737,3064,3280,1914,1.4011713030746706,898,0.39664310954063603,543,0.19839240043843626,216,0.07049608355091384,CHN,LBY,1262645000,1337705000,1379860000,1411100000,5154790,6491988,6192235,6653942,0.23244277513996173,49.29408762504993
India,Uganda,1313,1244,3591,3476,3497,3520,3277,1964,1.4958111195734958,2278,0.6343636869952659,-220,-0.06291106662853875,-243,-0.0690340909090909,IND,UGA,1059633675,1240613620,1322866505,1396387127,24020697,32341728,37477356,44404611,0.234677041676853,7.379864221758411
Pakistan,Jordan,5168,4558,3949,2965,6120,2526,3273,-1895,-0.3666795665634675,-1219,-0.3086857432261332,-2847,-0.46519607843137256,747,0.29572446555819476,PAK,JOR,154369924,194454498,210969298,227196741,5056174,6931258,9494246,10928721,1.4406016501794805,29.948609722949282
Myanmar,Norway,30,47,56,510,2428,3109,3258,3228,107.6,26,0.4642857142857143,830,0.3418451400329489,149,0.04792537793502734,MMR,NOR,45538332,49390988,51483949,53423198,4490967,4889252,5188607,5379475,6.098474299498132,60.56353082782242
China,Namibia,4593,4392,4078,3224,3106,3039,3252,-1341,-0.2919660352710647,-515,-0.1262873957822462,146,0.04700579523502898,213,0.0700888450148075,CHN,NAM,1262645000,1337705000,1379860000,1411100000,1819141,2099271,2282704,2489098,0.23045850754730354,130.64973737474378
Russian Federation,Mongolia,2755,3042,3362,2740,2433,3012,3232,477,0.17313974591651543,607,0.18054729327781083,799,0.3284011508425812,220,0.07304116865869854,RUS,MNG,146596869,142849468,144640716,145245148,2450979,2702520,2964749,3294335,2.2252034195317836,98.1078123505958
India,Hungary,978,867,755,928,1108,1110,3217,2239,2.289366053169734,-223,-0.295364238410596,2109,1.9034296028880866,2107,1.8981981981981981,IND,HUN,1059633675,1240613620,1322866505,1396387127,10210971,10000023,9843028,9750149,0.23038023896076779,32.99436757325452
China,Vietnam,612,1192,2573,2661,2440,3005,3167,2555,4.17483660130719,1961,0.7621453556160125,727,0.29795081967213116,162,0.05391014975041598,CHN,VNM,1262645000,1337705000,1379860000,1411100000,79001142,87411012,92191398,96648685,0.22443483806959108,3.2768164409065683
New Zealand,South Korea,39,558,1256,1268,1781,1725,3161,3122,80.05128205128206,1217,0.9689490445859873,1380,0.7748455923638405,1436,0.832463768115942,NZL,KOR,3857700,4350700,4609400,5090200,47008111,49554112,51014947,51836239,62.0997210325724,6.098050439191779
South Korea,Peru,414,415,486,571,1078,1691,3154,2740,6.618357487922705,72,0.14814814814814814,2076,1.9257884972170687,1463,0.8651685393258427,KOR,PER,47008111,49554112,51014947,51836239,26654439,29229572,30711863,33304756,6.0845463730499425,9.470118922354514
Pakistan,Finland,139,237,334,860,1179,2129,3134,2995,21.546762589928058,195,0.5838323353293413,1955,1.6581849024597117,1005,0.47205260685767964,PAK,FIN,154369924,194454498,210969298,227196741,5176209,5363352,5479531,5529543,1.3794211951306115,56.67737822094882
Bangladesh,China,470,857,1273,1839,2323,2865,3115,2645,5.627659574468085,803,0.6307934014139828,792,0.340938441670254,250,0.08726003490401396,BGD,CHN,129193327,148391139,157830000,167420951,1262645000,1337705000,1379860000,1411100000,1.8605795639041616,0.22074976968322588
Pakistan,Myanmar,5171,4685,3980,3371,3102,2975,3101,-2070,-0.4003094179075614,-1191,-0.2992462311557789,-1,-3.223726627981947e-4,126,0.042352941176470586,PAK,MMR,154369924,194454498,210969298,227196741,45538332,49390988,51483949,53423198,1.3648963388959878,5.804594475980267
China,Ecuador,654,934,1214,1453,2313,2928,3061,2407,3.680428134556575,560,0.4612850082372323,748,0.3233895373973195,133,0.045423497267759565,CHN,ECU,1262645000,1337705000,1379860000,1411100000,12626507,14989585,16195902,17588595,0.21692296789738502,17.40332300561813
Myanmar,New Zealand,363,594,682,806,1515,2200,3047,2684,7.393939393939394,319,0.46774193548387094,1532,1.0112211221122112,847,0.385,MMR,NZL,45538332,49390988,51483949,53423198,3857700,4350700,4609400,5090200,5.703514791458198,59.86012337432714
Thailand,Libya,2762,2410,2098,2312,2537,2841,3041,279,0.10101375814627082,-664,-0.31649189704480457,504,0.19865983445013796,200,0.0703977472720873,THA,LBY,63066603,68270489,70294397,71475664,5154790,6491988,6192235,6653942,4.2545949625595645,45.70223184993196
Myanmar,Laos,404,360,282,245,1540,2835,3032,2628,6.5049504950495045,-122,-0.4326241134751773,1492,0.9688311688311688,197,0.06948853615520283,MMR,LAO,45538332,49390988,51483949,53423198,5430853,6323418,6787419,7319399,5.675437101313178,41.424166109813115
Philippines,Palau,1569,2654,2892,3179,3247,2919,3021,1452,0.9254302103250478,1323,0.4574688796680498,-226,-0.06960271019402525,102,0.03494347379239465,PHL,PLW,77958223,94636700,103031365,112190977,19726,18540,17794,17972,2.692729915347827,16809.481415535276
Philippines,North Korea,1116,1444,1771,2214,2656,2925,2990,1874,1.67921146953405,655,0.36984754376058726,334,0.12575301204819278,65,0.022222222222222223,PHL,PRK,77958223,94636700,103031365,112190977,23367059,24686435,25258015,25867467,2.6650984597451184,11.558920709167234
Cambodia,Germany,1666,1266,865,1583,2171,2227,2987,1321,0.7929171668667467,-801,-0.9260115606936417,816,0.375863657300783,760,0.34126627750336774,KHM,DEU,12118841,14363532,15417523,16396860,82211508,81776930,81686611,83160871,18.21690250450391,3.591833471777851
Bangladesh,Finland,115,231,347,875,1197,1885,2983,2868,24.93913043478261,232,0.6685878962536023,1786,1.492063492063492,1098,0.5824933687002652,BGD,FIN,129193327,148391139,157830000,167420951,5176209,5363352,5479531,5529543,1.7817363849522034,53.946591969716124
China,Mauritius,346,3273,8024,5151,2564,2951,2981,2635,7.615606936416185,7678,0.9568793619142573,417,0.1626365054602184,30,0.010166045408336157,CHN,MUS,1262645000,1337705000,1379860000,1411100000,1186873,1250400,1262879,1266014,0.21125363191836158,235.46343089412915
Nepal,Bahrain,228,250,274,1066,2095,2271,2942,2714,11.903508771929825,46,0.1678832116788321,847,0.40429594272076375,671,0.2954645530603259,NPL,BHR,24559500,27161567,27610325,29348627,711442,1213645,1362142,1477469,10.024319025213684,199.12431326816332
Malaysia,France,1901,1962,2023,2262,2383,2640,2901,1000,0.5260389268805892,122,0.06030647553138903,518,0.21737305916911456,261,0.09886363636363636,MYS,FRA,22945150,28717731,31068833,33199993,60921384,65030575,66548272,67571107,8.73795364956854,4.293255103841942
Indonesia,Egypt,1481,1725,2107,2508,2698,1854,2897,1416,0.9561107359891965,626,0.2971048884670147,199,0.0737583395107487,1043,0.5625674217907227,IDN,EGY,214072421,244016173,259091970,271857970,71371371,87252413,97723799,107465134,1.0656299684721402,2.6957580493036932
Indonesia,Sweden,1276,1514,1624,1906,2127,2269,2897,1621,1.2703761755485894,348,0.21428571428571427,770,0.3620122237893747,628,0.27677390921110623,IDN,SWE,214072421,244016173,259091970,271857970,8872109,9378126,9799186,10353442,1.0656299684721402,27.981032781175575
Afghanistan,Kuwait,1334,1068,1219,1317,1794,2669,2896,1562,1.1709145427286356,-115,-0.09433962264150944,1102,0.6142697881828316,227,0.08505058074185089,AFG,KWT,19542982,28189672,33753499,38972230,1934901,2943356,3908743,4360444,7.430932230462562,66.4152549602747
South Korea,Guam,3582,3411,3240,2964,2687,2711,2865,-717,-0.20016750418760468,-342,-0.10555555555555556,178,0.06624488276888724,154,0.056805606787163405,KOR,GUM,47008111,49554112,51014947,51836239,160188,164905,167978,169231,5.527021356622729,1692.9522368833134
Bangladesh,Greece,7665,6129,4694,7361,10390,9791,2851,-4814,-0.6280495759947815,-2971,-0.6329356625479335,-7539,-0.7256015399422522,-6940,-0.7088142171381882,BGD,GRC,129193327,148391139,157830000,167420951,10805808,11121341,10820883,10698599,1.7028932060002455,26.64834900345363
Brazil,North Korea,479,1140,1801,2163,2525,2780,2841,2362,4.931106471816284,1322,0.7340366463076069,316,0.12514851485148515,61,0.02194244604316547,BRA,PRK,175873720,196353492,205188205,213196304,23367059,24686435,25258015,25867467,1.332574696041635,10.982907603593347
Malaysia,Egypt,2445,2168,2063,2456,2642,1815,2836,391,0.15991820040899796,-382,-0.1851672321861367,194,0.07342922028766086,1021,0.562534435261708,MYS,EGY,22945150,28717731,31068833,33199993,71371371,87252413,97723799,107465134,8.542170475758835,2.638995453167164
Thailand,Spain,271,346,572,953,1630,2084,2812,2541,9.376383763837639,301,0.5262237762237763,1182,0.7251533742331289,728,0.3493282149712092,THA,ESP,63066603,68270489,70294397,71475664,40567864,46576897,46444832,47365655,3.9342061935933885,5.936791120063683
India,Luxembourg,187,177,170,147,127,193,2791,2604,13.925133689839573,-17,-0.1,2664,20.976377952755904,2598,13.461139896373057,IND,LUX,1059633675,1240613620,1322866505,1396387127,436300,506953,569604,630419,0.19987293967656292,442.72142812954564
Timor-Leste,United Kingdom,330,1300,2293,1956,2064,2470,2787,2457,7.445454545454545,1963,0.8560837331007414,723,0.3502906976744186,317,0.12834008097165991,TLS,GBR,878360,1088486,1205813,1299995,58892514,62766365,65116219,67081234,214.38543994399978,4.154664179254663
Sri Lanka,Lebanon,5054,5965,6876,5279,3757,3176,2771,-2283,-0.4517214087851207,1822,0.2649796393251891,-986,-0.26244343891402716,-405,-0.12751889168765743,LKA,LBN,18776371,20668557,21336697,21919000,4320642,4995800,6398940,5662923,12.64200009124504,48.93232699791256
Bangladesh,Switzerland,730,1055,1385,1576,1829,2257,2761,2031,2.782191780821918,655,0.4729241877256318,932,0.5095680699835976,504,0.22330527248560036,BGD,CHE,129193327,148391139,157830000,167420951,7184250,7824909,8282396,8638167,1.6491364930784558,31.962799515221228
South Korea,Paraguay,5162,4026,2877,2740,2610,2547,2759,-2403,-0.46551724137931033,-2285,-0.7942301007994439,149,0.057088122605363986,212,0.08323517864153906,KOR,PRY,47008111,49554112,51014947,51836239,5123819,5768613,6177950,6618695,5.322531212189217,41.684954511425595
India,Cyprus,684,967,1250,1880,2885,2648,2732,2048,2.9941520467836256,566,0.4528,-153,-0.053032928942807624,84,0.03172205438066465,IND,CYP,1059633675,1240613620,1322866505,1396387127,948237,1129686,1187280,1237537,0.19564775033907914,220.76107623448834
Bangladesh,Belgium,554,820,1064,1608,1961,2706,2694,2140,3.862815884476534,510,0.4793233082706767,733,0.3737888832228455,-12,-0.004434589800443459,BGD,BEL,129193327,148391139,157830000,167420951,10251250,10895586,11274196,11538604,1.6091176067922346,23.347711733585797
India,Peru,128,129,151,177,402,1434,2673,2545,19.8828125,23,0.152317880794702,2271,5.649253731343284,1239,0.8640167364016736,IND,PER,1059633675,1240613620,1322866505,1396387127,26654439,29229572,30711863,33304756,0.19142256100159535,8.025880748082946
Bangladesh,New Zealand,252,791,1155,1374,1463,1530,2652,2400,9.523809523809524,903,0.7818181818181819,1189,0.8127136021872864,1122,0.7333333333333333,BGD,NZL,129193327,148391139,157830000,167420951,3857700,4350700,4609400,5090200,1.5840311407620662,52.100113944442256
Solomon Islands,Australia,1052,1263,1400,1640,1930,2300,2627,1575,1.497148288973384,348,0.24857142857142858,697,0.361139896373057,327,0.14217391304347826,SLB,AUS,429978,540394,612660,691191,19028802,22031750,23815995,25649248,380.0686062173842,10.242015672350316
Pakistan,Libya,1104,1445,1810,1995,2189,2451,2625,1521,1.377717391304348,706,0.39005524861878454,436,0.19917770671539517,174,0.07099143206854346,PAK,LBY,154369924,194454498,210969298,227196741,5154790,6491988,6192235,6653942,1.1553862913905089,39.45029878529149
China,Northern Mariana Islands,2598,7844,13566,9611,2894,2592,2614,16,0.006158583525789068,10968,0.8084918177797434,-280,-0.0967519004837595,22,0.008487654320987654,CHN,MNP,1262645000,1337705000,1379860000,1411100000,80338,54087,51514,49587,0.18524555311459145,5271.5429447234155
Indonesia,Spain,595,682,1063,1057,1967,1937,2614,2019,3.3932773109243697,468,0.44026340545625586,647,0.3289273004575496,677,0.3495095508518327,IDN,ESP,214072421,244016173,259091970,271857970,40567864,46576897,46444832,47365655,0.9615314938164219,5.51876670976048
France,South Korea,507,929,1647,1467,1869,1857,2608,2101,4.1439842209072975,1140,0.692167577413479,739,0.39539860888175493,751,0.4044157242864836,FRA,KOR,60921384,65030575,66548272,67571107,47008111,49554112,51014947,51836239,3.859637818276383,5.031229213986763
Bangladesh,Lebanon,433,2124,3814,3646,3498,2957,2582,2149,4.963048498845265,3381,0.8864708966963818,-916,-0.26186392224128074,-375,-0.12681772066283395,BGD,LBN,129193327,148391139,157830000,167420951,4320642,4995800,6398940,5662923,1.5422203640451186,45.59482797134978
South Korea,Austria,0,0,0,0,0,2210,2553,2553,1,0,0,2553,1,343,0.15520361990950227,KOR,AUT,47008111,49554112,51014947,51836239,8011566,8363404,8642699,8916864,4.925125837158054,28.63114206967831
South Korea,Czechia,19,28,37,553,1013,1428,2552,2533,133.31578947368422,18,0.4864864864864865,1539,1.5192497532082923,1124,0.7871148459383753,KOR,CZE,47008111,49554112,51014947,51836239,10255063,10474410,10546059,10697858,4.923196684852078,23.855242797202955
Cambodia,Switzerland,1637,1716,1803,1988,2381,2393,2533,896,0.5473427000610873,166,0.0920687742651137,152,0.063838723225535493,140,0.05850396991224405,KHM,CHE,12118841,14363532,15417523,16396860,7184250,7824909,8282396,8638167,15.448079693307134,29.323350659925886
Myanmar,Germany,276,431,585,1271,1833,1881,2522,2246,8.13768115942029,309,0.5282051282051282,689,0.375886524822695,641,0.34077618288144607,MMR,DEU,45538332,49390988,51483949,53423198,82211508,81776930,81686611,83160871,4.720795636382531,3.0326762691073785
Malaysia,Switzerland,1121,1362,1609,1802,2124,2260,2507,1386,1.2363960749330956,488,0.30329397141081416,383,0.1803201506591337,247,0.10929203539823008,MYS,CHE,22945150,28717731,31068833,33199993,7184250,7824909,8282396,8638167,7.551206411398942,29.02236087818168
New Zealand,Malaysia,746,853,1204,1614,1921,2343,2482,1736,2.3270777479892764,458,0.3803986710963455,561,0.2920353982300885,139,0.05932565087494665,NZL,MYS,3857700,4350700,4609400,5090200,22945150,28717731,31068833,33199993,48.76036305056776,7.4759051907029015
China,Sri Lanka,37,312,588,1153,2312,2447,2481,2444,66.05405405405405,551,0.9370748299319728,169,0.07309688581314878,34,0.013894564773191663,CHN,LKA,1262645000,1337705000,1379860000,1411100000,18776371,20668557,21336697,21919000,0.17582028204946495,11.318947032255121
Afghanistan,Malaysia,32,36,50,271,506,545,2478,2446,76.4375,18,0.36,1972,3.897233201581028,1933,3.546788990825688,AFG,MYS,19542982,28189672,33753499,38972230,22945150,28717731,31068833,33199993,6.358373641949665,7.463856995391535
Afghanistan,Israel,2724,2836,2790,2610,2462,2539,2464,-260,-0.09544787077826726,66,0.023655913978494623,2,8.123476848090983e-4,-75,-0.029539188656951557,AFG,ISR,19542982,28189672,33753499,38972230,6289000,7623600,8380100,9215100,6.322450627023397,26.738722314462134
India,Mozambique,900,1238,1441,1980,2256,2338,2455,1555,1.7277777777777779,541,0.3754337265787647,199,0.08820921985815602,117,0.05004277159965783,IND,MOZ,1059633675,1240613620,1322866505,1396387127,17768505,23073723,26843246,31178239,0.17581084446648582,7.874081663175397
Nepal,Vietnam,106,299,774,1375,1944,2315,2440,2334,22.0188679245283,668,0.8630490956072352,496,0.2551440329218107,125,0.05399568034557235,NPL,VNM,24559500,27161567,27610325,29348627,79001142,87411012,92191398,96648685,8.313847186105162,2.5246075515667905
Nepal,Italy,11,103,195,985,1647,1878,2437,2426,220.54545454545453,184,0.9435897435897436,790,0.47965998785670916,559,0.2976570820021299,NPL,ITA,24559500,27161567,27610325,29348627,56942108,59277417,60730582,59438851,8.303625242843559,4.100011960190819
China,Turkey,529,1020,1634,1702,1736,1730,2415,1886,3.5652173913043477,1105,0.6762545899632803,679,0.3911290322580645,685,0.3959537572254335,CHN,TUR,1262645000,1337705000,1379860000,1411100000,64113547,73142150,78218479,83384680,0.1711430798667706,2.8962154678773127
Germany,Thailand,2551,2303,2531,2247,2126,2281,2387,-164,-0.06428851430811447,-20,-0.007902015013828527,261,0.12276575729068674,106,0.046470846120122755,DEU,THA,82211508,81776930,81686611,83160871,63066603,68270489,70294397,71475664,2.870340307041758,3.3395982162544167
Vietnam,Romania,4,6,8,9,21,80,2383,2379,594.75,4,0.5,2362,112.47619047619048,2303,28.7875,VNM,ROU,79001142,87411012,92191398,96648685,22442971,20246871,19815616,19265250,2.465631063681829,12.36942162702275
Germany,India,5654,4140,2626,2687,2734,2547,2382,-3272,-0.5787053413512557,-3028,-1.153084539223153,-352,-0.12874908558888076,-165,-0.06478209658421673,DEU,IND,82211508,81776930,81686611,83160871,1059633675,1240613620,1322866505,1396387127,2.8643278640022904,0.17058306782858218
Libya,Indonesia,13860,9170,4480,3161,2045,2263,2378,-11482,-0.8284271284271284,-9380,-2.09375,333,0.16283618581907092,115,0.05081749889527176,LBY,IDN,5154790,6491988,6192235,6653942,214072421,244016173,259091970,271857970,35.738213528161204,0.8747214584144801
Malaysia,Indonesia,5406,3577,1748,1837,2045,2263,2378,-3028,-0.5601183869774324,-3658,-2.0926773455377576,333,0.16283618581907092,115,0.05081749889527176,MYS,IDN,22945150,28717731,31068833,33199993,214072421,244016173,259091970,271857970,7.162652112607373,0.8747214584144801
Saudi Arabia,Indonesia,5544,3668,1792,1858,2045,2263,2378,-3166,-0.5710678210678211,-3752,-2.09375,333,0.16283618581907092,115,0.05081749889527176,SAU,IDN,21547390,29411929,32749848,35997107,214072421,244016173,259091970,271857970,6.606086428001006,0.8747214584144801
Syrian Arab Republic,Indonesia,3465,2292,1120,1533,2045,2263,2378,-1087,-0.3137085137085137,-2345,-2.09375,333,0.16283618581907092,115,0.05081749889527176,SYR,IDN,16307654,22337563,19205178,20772595,214072421,244016173,259091970,271857970,11.44777530202654,0.8747214584144801
Vietnam,Slovakia,241,713,1381,1546,1737,2145,2373,2132,8.846473029045644,1140,0.8254887762490949,636,0.36614853195164077,228,0.1062937062937063,VNM,SVK,79001142,87411012,92191398,96648685,5388720,5391428,5423801,5458827,2.455284311421309,43.470877534679154
New Zealand,Hong Kong,1506,1681,1856,2026,2201,2249,2345,839,0.5571049136786188,350,0.18857758620689655,144,0.06542480690595184,96,0.0426856380613606,NZL,HKG,3857700,4350700,4609400,5090200,6665000,7024200,7291300,7481000,46.068916741974775,31.346076727710198
Thailand,Qatar,1377,2329,2935,1725,1916,2291,2331,954,0.6928104575163399,1558,0.5308347529812606,415,0.21659707724425886,40,0.017459624618070713,THA,QAT,63066603,68270489,70294397,71475664,645937,1713504,2414573,2760385,3.261249871005046,84.44474230949669
China,Belize,551,823,1094,1378,1737,2048,2323,1772,3.215970961887477,543,0.4963436928702011,586,0.33736327000575705,275,0.13427734375,CHN,BLZ,1262645000,1337705000,1379860000,1411100000,240406,322106,359871,394921,0.1646233434908936,588.2189096047058
Indonesia,Lebanon,84,2911,5738,4405,3135,2650,2312,2228,26.523809523809526,5654,0.9853607528755663,-823,-0.2625199362041467,-338,-0.12754716981132075,IDN,LBN,214072421,244016173,259091970,271857970,4320642,4995800,6398940,5662923,0.8504440756325813,40.82697221911723
Myanmar,Pakistan,3598,3000,2662,2551,2479,2460,2297,-1301,-0.36158977209560866,-936,-0.3516153268219384,-182,-0.07341670028237192,-163,-0.06626016260162601,MMR,PAK,45538332,49390988,51483949,53423198,154369924,194454498,210969298,227196741,4.299630284207247,1.0110180233615236
Russian Federation,China,274,580,939,1356,1713,2113,2297,2023,7.383211678832117,665,0.7082002129925452,584,0.3409223584354933,184,0.08707998106956934,RUS,CHN,146596869,142849468,144640716,145245148,1262645000,1337705000,1379860000,1411100000,1.5814641877056024,0.16278080929771102
France,Hong Kong,1470,1641,1811,1978,2149,2196,2289,819,0.5571428571428572,341,0.1882937603533959,140,0.06514657980456026,93,0.04234972677595628,FRA,HKG,60921384,65030575,66548272,67571107,6665000,7024200,7291300,7481000,3.3875425483261656,30.597513701376823
Philippines,Iceland,135,405,675,1056,1407,1565,2284,2149,15.91851851851852,540,0.8,877,0.6233120113717129,719,0.4594249201277955,PHL,ISL,77958223,94636700,103031365,112190977,281205,318041,330815,366463,2.035814341825368,623.2552808878386
China,Guam,1719,2215,2710,2422,2133,2152,2275,556,0.32344386271087844,991,0.36568265682656825,142,0.06657290201593999,123,0.05715613382899628,CHN,GUM,1262645000,1337705000,1379860000,1411100000,160188,164905,167978,169231,0.16122174190347954,1344.3163486595247
China,Kazakhstan,695,1142,1588,1811,2033,2162,2274,1579,2.2719424460431656,893,0.5623425692695214,241,0.11854402361042794,112,0.05180388529139685,CHN,KAZ,1262645000,1337705000,1379860000,1411100000,14883626,16321872,17542806,18755666,0.16115087520374177,12.124336187262026
Canada,Indonesia,286,189,92,983,1938,2144,2253,1967,6.8776223776223775,-194,-2.108695652173913,315,0.16253869969040247,109,0.05083955223880597,CAN,IDN,30685730,34005902,35704498,38028638,214072421,244016173,259091970,271857970,5.924482491326668,0.8287415667820958
Sri Lanka,Belgium,238,238,230,488,1196,1901,2246,2008,8.436974789915967,-8,-0.034782608695652174,1050,0.8779264214046822,345,0.18148342977380327,LKA,BEL,18776371,20668557,21336697,21919000,10251250,10895586,11274196,11538604,10.246817829280534,19.465093004318373
Mongolia,Austria,993,1120,1247,1383,1537,1825,2242,1249,1.257804632426989,254,0.2036888532477947,705,0.4586857514638907,417,0.2284931506849315,MNG,AUT,2450979,2702520,2964749,3294335,8011566,8363404,8642699,8916864,68.05622379023384,25.143368789744915
China,Brunei Darussalam,1509,1718,1926,1969,2012,2055,2238,729,0.4831013916500994,417,0.21651090342679127,226,0.11232604373757456,183,0.08905109489051095,CHN,BRN,1262645000,1337705000,1379860000,1411100000,333926,396053,421437,441725,0.1585996740131812,506.6500650857434
Nepal,Norway,52,71,164,325,719,1559,2233,2181,41.94230769230769,112,0.6829268292682927,1514,2.1057023643949933,674,0.4323284156510584,NPL,NOR,24559500,27161567,27610325,29348627,4490967,4889252,5188607,5379475,7.608533101054437,41.50962686879296
Pakistan,Portugal,250,540,852,1395,1708,1935,2217,1967,7.868,602,0.7065727699530516,509,0.2980093676814988,282,0.14573643410852713,PAK,PRT,154369924,194454498,210969298,227196741,10289898,10573100,10358076,10297081,0.975806250671527,21.53037351070658
Vietnam,Spain,363,423,665,765,1112,1634,2205,1842,5.074380165289257,302,0.45413533834586467,1093,0.9829136690647482,571,0.34944920440636473,VNM,ESP,79001142,87411012,92191398,96648685,40567864,46576897,46444832,47365655,2.281458873444579,4.655271842012953
Pakistan,Thailand,1086,1820,2930,2463,2215,1593,2202,1116,1.0276243093922652,1844,0.6293515358361774,-13,-0.005869074492099322,609,0.3822975517890772,PAK,THA,154369924,194454498,210969298,227196741,63066603,68270489,70294397,71475664,0.9692040432921527,3.0807688614127464
Iran,India,3051,2569,2086,2330,2518,2346,2194,-857,-0.28089151098000653,-965,-0.462607861936721,-324,-0.12867355043685463,-152,-0.06479113384484228,IRN,IND,65544383,75373855,81790841,87290193,1059633675,1240613620,1322866505,1396387127,2.513455320232824,0.15711975265151523
China,Madagascar,1481,1312,1458,1609,1784,1979,2193,712,0.48075624577987847,-23,-0.01577503429355281,409,0.22926008968609865,214,0.10813542193026782,CHN,MDG,1262645000,1337705000,1379860000,1411100000,16216431,21731053,24850912,28225177,0.1554106725249805,7.76965898212082
Iran,Ukraine,2580,2496,2443,2232,2129,2136,2170,-410,-0.15891472868217055,-137,-0.056078591895210805,41,0.01925786754344763,34,0.015917602996254682,IRN,UKR,65544383,75373855,81790841,87290193,49176500,45870741,45167350,44207754,2.485960822655072,4.908641140194546
Hong Kong,Ireland,86,468,1108,1610,1847,1887,2162,2076,24.13953488372093,1022,0.9223826714801444,315,0.1705468327016784,275,0.14573396926338103,HKG,IRL,6665000,7024200,7291300,7481000,3805174,4560155,4701957,4985382,28.899879695227913,43.366787138879225
South Africa,South Korea,0,190,442,830,1549,1212,2160,2160,1,442,1,611,0.394448030987734,948,0.7821782178217822,ZAF,KOR,46813266,51784921,55876504,58801927,47008111,49554112,51014947,51836239,3.673349004361711,4.1669689809092825
India,Mexico,128,347,583,684,864,1965,2154,2026,15.828125,455,0.7804459691252144,1290,1.4930555555555556,189,0.09618320610687023,IND,MEX,1059633675,1240613620,1322866505,1396387127,97873442,112532401,120149897,125998302,0.15425521750745846,1.7095468477027571
Iran,Pakistan,4108,3060,2940,2381,2345,2301,2148,-1960,-0.4771178188899708,-1168,-0.39727891156462586,-197,-0.08400852878464819,-153,-0.06649282920469361,IRN,PAK,65544383,75373855,81790841,87290193,154369924,194454498,210969298,227196741,2.4607575332087994,0.945436096726405
United Kingdom,Thailand,21,36,59,951,1913,2052,2147,2126,101.23809523809524,38,0.6440677966101694,234,0.12232096184004182,95,0.046296296296296294,GBR,THA,58892514,62766365,65116219,67081234,63066603,68270489,70294397,71475664,3.20059705520623,3.003819593757114
Kyrgyzstan,South Korea,0,0,0,635,1524,851,2126,2126,1,0,0,602,0.39501312335958005,1275,1.498237367802585,KGZ,KOR,4898400,5447900,5956900,6579900,47008111,49554112,51014947,51836239,32.310521436495996,4.1013778025060805
Germany,South Korea,645,799,1208,1106,1442,1343,2121,1476,2.2883720930232556,563,0.46605960264900664,679,0.470873786407767,778,0.5793000744601638,DEU,KOR,82211508,81776930,81686611,83160871,47008111,49554112,51014947,51836239,2.5504783373420894,4.091732040976198
Philippines,Cayman Islands,33,64,111,879,1730,1885,2104,2071,62.75757575757576,78,0.7027027027027027,374,0.2161849710982659,219,0.11618037135278515,PHL,CYM,77958223,94636700,103031365,112190977,39658,54074,60911,67311,1.875373631874157,3125.7892469284366
Pakistan,Brazil,127,150,172,215,256,301,2094,1967,15.488188976377952,45,0.2616279069767442,1838,7.1796875,1793,5.956810631229236,PAK,BRA,154369924,194454498,210969298,227196741,175873720,196353492,205188205,213196304,0.9216681501606575,0.9821933873675408
North Korea,Mali,0,0,0,0,1434,1764,2069,2069,1,0,0,635,0.44281729428172945,305,0.17290249433106575,PRK,MLI,23367059,24686435,25258015,25867467,11239101,15529181,18112907,21224040,7.998463861962209,9.748379667584494
China,Lebanon,88,2596,5103,3918,2789,2358,2058,1970,22.386363636363637,5015,0.9827552420145013,-731,-0.2621011115095016,-300,-0.1272264631043257,CHN,LBN,1262645000,1337705000,1379860000,1411100000,4320642,4995800,6398940,5662923,0.14584366806037843,36.341656067016984
Germany,Hong Kong,1323,1476,1629,1778,1932,1974,2058,735,0.5555555555555556,306,0.1878453038674033,126,0.06521739130434782,84,0.0425531914893617,DEU,HKG,82211508,81776930,81686611,83160871,6665000,7024200,7291300,7481000,2.4747215550448,27.509691217751637
India,Vietnam,116,350,933,1143,1614,1938,2043,1927,16.612068965517242,817,0.8756698821007503,429,0.26579925650557623,105,0.05417956656346749,IND,VNM,1059633675,1240613620,1322866505,1396387127,79001142,87411012,92191398,96648685,0.14630613248270083,2.1138414868241613
South Korea,Mexico,128,300,487,2102,3961,1863,2041,1913,14.9453125,359,0.7371663244353183,-1920,-0.4847260792729109,178,0.09554482018250134,KOR,MEX,47008111,49554112,51014947,51836239,97873442,112532401,120149897,125998302,3.937399856498077,1.6198630994249432
Iran,Russian Federation,3096,2829,2461,2240,1974,2012,2010,-1086,-0.3507751937984496,-635,-0.25802519301097115,36,0.0182370820668693,-2,-9.940357852882703e-4,IRN,RUS,65544383,75373855,81790841,87290193,146596869,142849468,144640716,145245148,2.302664172136726,1.3838672256370312
South Korea,South Africa,1625,1013,700,920,1339,1727,2005,380,0.23384615384615384,-925,-1.3214285714285714,666,0.49738610903659447,278,0.16097278517660682,KOR,ZAF,47008111,49554112,51014947,51836239,46813266,51784921,55876504,58801927,3.867950373482922,3.409752200807977
South Korea,Mongolia,276,304,336,866,1497,1853,1987,1711,6.199275362318841,60,0.17857142857142858,490,0.3273213092852371,134,0.07231516459794927,KOR,MNG,47008111,49554112,51014947,51836239,2450979,2702520,2964749,3294335,3.8332256319753446,60.31566310044364
Nepal,Netherlands,206,303,413,658,1340,1730,1973,1767,8.577669902912621,207,0.5012106537530266,633,0.47238805970149256,243,0.14046242774566475,NPL,NLD,24559500,27161567,27610325,29348627,15925513,16615394,16939923,17441500,6.722631351715362,11.312100450075969
Timor-Leste,Portugal,654,1411,2227,2040,1516,1717,1969,1315,2.010703363914373,1573,0.7063313875168388,453,0.29881266490765174,252,0.14676761793826443,TLS,PRT,878360,1088486,1205813,1299995,10289898,10573100,10358076,10297081,151.4621210081577,19.121923970492222
Turkmenistan,Iran,237,238,944,2990,2999,2344,1954,1717,7.244725738396625,707,0.7489406779661016,-1045,-0.3484494831610537,-390,-0.16638225255972697,TKM,IRN,4569132,5267970,5766431,6250438,65544383,75373855,81790841,87290193,31.261809172413194,2.2385103444553045
Hong Kong,South Africa,1786,1075,679,892,1298,1674,1943,157,0.08790593505039193,-1107,-1.630338733431517,645,0.49691833590138673,269,0.16069295101553166,HKG,ZAF,6665000,7024200,7291300,7481000,46813266,51784921,55876504,58801927,25.972463574388453,3.3043134793864835
Japan,Vietnam,124,224,471,809,1542,1843,1942,1818,14.661290322580646,347,0.7367303609341825,400,0.2594033722438392,99,0.05371676614215952,JPN,VNM,126843000,128070000,127141000,126261000,79001142,87411012,92191398,96648685,1.5380838105194794,2.009339288992913
Australia,Fiji,1306,1405,1489,1706,1832,1887,1941,635,0.48621745788667686,183,0.1229012760241773,109,0.05949781659388646,54,0.028616852146263912,AUS,FJI,19028802,22031750,23815995,25649248,832509,905169,917200,920422,7.567473323194505,210.8815304284339
South Korea,Hungary,1076,953,830,1019,1217,1160,1931,855,0.7946096654275093,-246,-0.2963855421686747,714,0.5866885784716516,771,0.6646551724137931,KOR,HUN,47008111,49554112,51014947,51836239,10210971,10000023,9843028,9750149,3.725193102840659,19.804825546768566
Philippines,Panama,223,323,444,822,1368,1601,1923,1700,7.623318385650224,221,0.49774774774774777,555,0.4057017543859649,322,0.20112429731417863,PHL,PAN,77958223,94636700,103031365,112190977,3001731,3623617,3957099,4294396,1.714041584645439,44.779289101424276
South Korea,Guatemala,290,709,1127,1340,1553,1703,1921,1631,5.624137931034483,837,0.7426796805678794,368,0.2369607211848036,218,0.1280093951849677,KOR,GTM,47008111,49554112,51014947,51836239,11589761,14259687,15567419,16858333,3.7059015797808943,11.394958208501398
Bangladesh,Denmark,241,320,398,551,672,1320,1919,1678,6.962655601659751,157,0.3944723618090452,1247,1.8556547619047619,599,0.4537878787878788,BGD,DNK,129193327,148391139,157830000,167420951,5339616,5547683,5683483,5831404,1.1462125788546023,32.908026951999894
South Korea,Vietnam,25,75,196,639,1495,1805,1902,1877,75.08,171,0.8724489795918368,407,0.27224080267558526,97,0.05373961218836565,KOR,VNM,47008111,49554112,51014947,51836239,79001142,87411012,92191398,96648685,3.6692476859673406,1.9679522799508342
Iran,Turkmenistan,2699,2204,1786,1771,1718,1904,1887,-812,-0.3008521674694331,-913,-0.5111982082866742,169,0.09837019790454016,-17,-0.008928571428571428,IRN,TKM,65544383,75373855,81790841,87290193,4569132,5267970,5766431,6250438,2.161754872050747,30.18988429290875
North Korea,Mexico,336,1219,2156,1033,30,1719,1885,1549,4.6101190476190474,1820,0.8441558441558441,1855,61.833333333333336,166,0.09656777196044211,PRK,MEX,23367059,24686435,25258015,25867467,97873442,112532401,120149897,125998302,7.287145664474996,1.4960519071122085
New Zealand,Thailand,2439,2194,2403,1963,1665,1786,1869,-570,-0.23370233702337023,-36,-0.0149812734082397,204,0.12252252252252252,83,0.04647256438969765,NZL,THA,3857700,4350700,4609400,5090200,63066603,68270489,70294397,71475664,36.71761423912616,2.6148760226977394
Pakistan,Fiji,1294,1382,1456,1650,1771,1824,1867,573,0.4428129829984544,162,0.11126373626373626,96,0.05420666290231508,43,0.023574561403508772,PAK,FJI,154369924,194454498,210969298,227196741,832509,905169,917200,920422,0.8217547451527926,202.84173998448537
Singapore,Vietnam,294,522,1046,1220,1451,1751,1845,1551,5.275510204081633,752,0.7189292543021033,394,0.2715368711233632,94,0.05368360936607653,SGP,VNM,4027887,5076732,5535002,5685807,79001142,87411012,92191398,96648685,32.44921960945913,1.9089757920658725
Bangladesh,Netherlands,401,590,800,988,1116,1338,1843,1442,3.596009975062344,399,0.49875,727,0.6514336917562724,505,0.3774289985052317,BGD,NLD,129193327,148391139,157830000,167420951,15925513,16615394,16939923,17441500,1.1008180212762022,10.566751712868733
Italy,Philippines,207,278,1020,825,1705,1731,1841,1634,7.893719806763285,813,0.7970588235294118,136,0.07976539589442816,110,0.0635470826112074,ITA,PHL,56942108,59277417,60730582,59438851,77958223,94636700,103031365,112190977,3.097300787325112,1.6409519278898874
Afghanistan,Hungary,274,403,532,2385,1821,9411,1816,1542,5.627737226277373,258,0.4849624060150376,-5,-0.0027457440966501922,-7595,-0.807034321538625,AFG,HUN,19542982,28189672,33753499,38972230,10210971,10000023,9843028,9750149,4.659728221864646,18.625356391989495
Nigeria,South Korea,0,150,348,643,1194,1052,1816,1816,1,348,1,622,0.5209380234505863,764,0.7262357414448669,NGA,KOR,122851984,160952853,183995785,208327405,47008111,49554112,51014947,51836239,0.8717048052319376,3.5033405876533594
Philippines,South Africa,1485,922,630,828,1205,1554,1804,319,0.21481481481481482,-855,-1.3571428571428572,599,0.4970954356846473,250,0.16087516087516088,PHL,ZAF,77958223,94636700,103031365,112190977,46813266,51784921,55876504,58801927,1.6079724486221385,3.067926668457651
Japan,India,903,890,876,1548,2063,1922,1797,894,0.9900332225913622,-27,-0.030821917808219176,-266,-0.12893843916626271,-125,-0.06503642039542143,JPN,IND,126843000,128070000,127141000,126261000,1059633675,1240613620,1322866505,1396387127,1.423242331361228,0.12868924134675155
China,Serbia,216,1375,1870,1845,1804,1763,1796,1580,7.314814814814815,1654,0.8844919786096257,-8,-0.004434589800443459,33,0.01871809415768576,CHN,SRB,1262645000,1337705000,1379860000,1411100000,7516346,7291436,7095383,6899126,0.12727659272907663,26.03228292975081
Mongolia,Hungary,386,625,863,1060,1265,862,1792,1406,3.6424870466321244,477,0.5527230590961761,527,0.416600790513834,930,1.0788863109048723,MNG,HUN,2450979,2702520,2964749,3294335,10210971,10000023,9843028,9750149,54.39641080825113,18.379206307513865
New Zealand,Papua New Guinea,2540,2602,1948,2068,1754,1778,1783,-757,-0.2980314960629921,-592,-0.30390143737166325,29,0.01653363740022805,5,0.00281214848143982,NZL,PNG,3857700,4350700,4609400,5090200,5508297,7583269,8682174,9749640,35.02809319869554,18.28785473104648
Philippines,Bermuda,92,142,345,708,1126,1302,1782,1690,18.369565217391305,253,0.7333333333333333,656,0.5825932504440497,480,0.3686635944700461,PHL,BMU,77958223,94636700,103031365,112190977,61833,65124,65237,63893,1.58836302851699,2789.037922777143
India,Malawi,1362,2683,2583,2462,2419,2083,1770,408,0.29955947136563876,1221,0.4727061556329849,-649,-0.2682926829268293,-313,-0.1502640422467595,IND,MWI,1059633675,1240613620,1322866505,1396387127,11229387,14718422,16938942,19377061,0.12675568012451321,9.134512194599584
India,Sudan,2259,2304,2351,2397,1396,1277,1764,-495,-0.21912350597609562,92,0.03913228413441089,368,0.2636103151862464,487,0.3813625685199687,IND,SDN,1059633675,1240613620,1322866505,1396387127,26298773,33739933,38171178,44440486,0.12632599985290469,3.969353530472192
Myanmar,Denmark,43,54,64,657,1193,1722,1764,1721,40.02325581395349,21,0.328125,571,0.4786253143336127,42,0.024390243902439025,MMR,DNK,45538332,49390988,51483949,53423198,5339616,5547683,5683483,5831404,3.3019363610542376,30.250004973073377
Kuwait,Sri Lanka,20,224,430,849,1711,1731,1753,1733,86.65,410,0.9534883720930233,42,0.024547048509643482,22,0.012709416522241479,KWT,LKA,1934901,2943356,3908743,4360444,18776371,20668557,21336697,21919000,40.202328019807155,7.997627628997673
India,Madagascar,1171,1037,1152,1282,1425,1581,1751,580,0.49530315969257044,-19,-0.016493055555555556,326,0.2287719298245614,170,0.10752688172043011,IND,MDG,1059633675,1240613620,1322866505,1396387127,16216431,21731053,24850912,28225177,0.12539502593108623,6.2036812027786405
France,India,5858,3628,1397,1734,1992,1856,1735,-4123,-0.703823830658928,-4461,-3.1932712956335005,-257,-0.1290160642570281,-121,-0.06519396551724138,FRA,IND,60921384,65030575,66548272,67571107,1059633675,1240613620,1322866505,1396387127,2.5676654964377006,0.12424921187346351
North Korea,Kyrgyzstan,800,1058,1280,1654,2017,1777,1729,929,1.16125,480,0.375,-288,-0.1427863163113535,-48,-0.027011817670230726,PRK,KGZ,23367059,24686435,25258015,25867467,4898400,5447900,5956900,6579900,6.684071540518444,26.27699509111081
Kazakhstan,South Korea,97,608,1314,1027,1145,924,1712,1615,16.649484536082475,1217,0.926179604261796,567,0.49519650655021835,788,0.8528138528138528,KAZ,KOR,14883626,16321872,17542806,18755666,47008111,49554112,51014947,51836239,9.127908334473434,3.3027087478318014
Indonesia,Norway,427,463,573,854,1244,1526,1711,1284,3.0070257611241216,146,0.2547993019197208,467,0.3754019292604502,185,0.12123197903014417,IDN,NOR,214072421,244016173,259091970,271857970,4490967,4889252,5188607,5379475,0.6293727566640772,31.806077730633568
Malaysia,Sweden,755,896,961,1140,1365,1461,1711,956,1.266225165562914,206,0.21436004162330904,346,0.25347985347985347,250,0.17111567419575632,MYS,SWE,22945150,28717731,31068833,33199993,8872109,9378126,9799186,10353442,5.153615544437013,16.5259051047951
United Arab Emirates,Sri Lanka,19,215,413,816,1645,1665,1688,1669,87.84210526315789,394,0.9539951573849879,43,0.026139817629179333,23,0.013813813813813814,ARE,LKA,3275333,8481771,8916899,9287289,18776371,20668557,21336697,21919000,18.17537927375793,7.701081253706829
Bangladesh,Portugal,76,165,261,849,1297,1470,1684,1608,21.157894736842106,185,0.7088122605363985,387,0.29838087895142634,214,0.145578231292517,BGD,PRT,129193327,148391139,157830000,167420951,10289898,10573100,10358076,10297081,1.0058478284477073,16.35414929726201
Malaysia,South Korea,51,149,294,585,1108,1087,1684,1633,32.01960784313726,243,0.826530612244898,576,0.51985559566787,597,0.5492180312787488,MYS,KOR,22945150,28717731,31068833,33199993,47008111,49554112,51014947,51836239,5.072290226085288,3.248692483264459
Thailand,Portugal,18,39,63,165,241,272,1676,1658,92.11111111111111,45,0.7142857142857143,1435,5.954356846473029,1404,5.161764705882353,THA,PRT,63066603,68270489,70294397,71475664,10289898,10573100,10358076,10297081,2.344854047106159,16.276457376609933
Mongolia,France,288,297,306,687,1339,1483,1630,1342,4.659722222222222,18,0.058823529411764705,291,0.2173263629574309,147,0.09912339851652056,MNG,FRA,2450979,2702520,2964749,3294335,60921384,65030575,66548272,67571107,49.478878134737364,2.412273636422739
Thailand,"China, Macao SAR",1923,2109,974,1129,1287,1519,1628,-295,-0.15340613624544983,-949,-0.9743326488706365,341,0.26495726495726496,109,0.07175773535220539,THA,MAC,63066603,68270489,70294397,71475664,431896,557297,615239,676283,2.2776983226066987,240.7276243821004
China,Cambodia,707,1853,2998,2340,1682,1518,1627,920,1.3012729844413014,2291,0.7641761174116077,-55,-0.032699167657550536,109,0.07180500658761528,CHN,KHM,1262645000,1337705000,1379860000,1411100000,12118841,14363532,15417523,16396860,0.11530012047338956,9.922631528231625
United Kingdom,Papua New Guinea,2192,2245,1680,1880,1594,1616,1621,-571,-0.26049270072992703,-512,-0.3047619047619048,27,0.016938519447929738,5,0.003094059405940594,GBR,PNG,58892514,62766365,65116219,67081234,5508297,7583269,8682174,9749640,2.4164731376289232,16.62625491813031
Papua New Guinea,New Zealand,1160,1560,1117,1199,1309,1399,1618,458,0.39482758620689656,-43,-0.03849597135183527,309,0.23605805958747136,219,0.15654038598999284,PNG,NZL,5508297,7583269,8682174,9749640,3857700,4350700,4609400,5090200,16.595484551224455,31.786570272287925
Afghanistan,Qatar,384,417,388,620,1356,1571,1599,1215,3.1640625,4,0.010309278350515464,243,0.17920353982300885,28,0.01782304264799491,AFG,QAT,19542982,28189672,33753499,38972230,645937,1713504,2414573,2760385,4.102921490507471,57.92670225349
Pakistan,Turkey,275,666,1060,1097,1131,2015,1599,1324,4.8145454545454545,785,0.7405660377358491,468,0.41379310344827586,-416,-0.2064516129032258,PAK,TUR,154369924,194454498,210969298,227196741,64113547,73142150,78218479,83384680,0.7037953066413043,1.9176184402218728
Vanuatu,Australia,861,1005,1060,1180,1300,1380,1592,731,0.8490127758420442,199,0.1877358490566038,292,0.2246153846153846,212,0.1536231884057971,VUT,AUS,192074,245453,276438,311685,19028802,22031750,23815995,25649248,510.7720936201614,6.206809649935935
China,Cyprus,398,563,728,1094,1679,1541,1591,1193,2.9974874371859297,330,0.4532967032967033,-88,-0.052412150089338895,50,0.03244646333549643,CHN,CYP,1262645000,1337705000,1379860000,1411100000,948237,1129686,1187280,1237537,0.112748919282829,128.56181269731735
Philippines,Czechia,8,13,17,177,320,509,1590,1582,197.75,9,0.5294117647058824,1270,3.96875,1081,2.1237721021611002,PHL,CZE,77958223,94636700,103031365,112190977,10255063,10474410,10546059,10697858,1.4172262712356984,14.86278841988742
China,Colombia,1233,1392,1551,1632,1632,1616,1584,351,0.2846715328467153,318,0.20502901353965183,-48,-0.029411764705882353,-32,-0.019801980198019802,CHN,COL,1262645000,1337705000,1379860000,1411100000,39215135,44816108,47119728,50930662,0.11225285238466444,3.1101107619610366
North Korea,Vietnam,56,228,648,867,1246,1503,1584,1528,27.285714285714285,592,0.9135802469135802,338,0.2712680577849117,81,0.05389221556886228,PRK,VNM,23367059,24686435,25258015,25867467,79001142,87411012,92191398,96648685,6.1235218740203665,1.63892555806631
Myanmar,Sweden,98,116,125,438,1342,1442,1556,1458,14.877551020408163,27,0.216,214,0.15946348733233978,114,0.07905686546463246,MMR,SWE,45538332,49390988,51483949,53423198,8872109,9378126,9799186,10353442,2.9125923910433067,15.02881843545364
Malaysia,Russian Federation,557,533,490,1018,1527,1556,1554,997,1.7899461400359067,-67,-0.13673469387755102,27,0.01768172888015717,-2,-0.0012853470437017994,MYS,RUS,22945150,28717731,31068833,33199993,146596869,142849468,144640716,145245148,4.680723878465878,1.0699152580298241
China,Bulgaria,362,443,524,657,780,1083,1550,1188,3.281767955801105,162,0.30916030534351147,770,0.9871794871794872,467,0.4312096029547553,CHN,BGR,1262645000,1337705000,1379860000,1411100000,8170172,7395599,7177991,6934015,0.10984338459357948,22.35357148780324
China,Poland,922,788,674,932,1221,1162,1550,628,0.6811279826464208,-248,-0.36795252225519287,329,0.26945126945126946,388,0.33390705679862304,CHN,POL,1262645000,1337705000,1379860000,1411100000,38258629,38042794,37986412,37899070,0.10984338459357948,4.089810119351213
China,Sudan,1678,1711,1746,1890,1215,1111,1536,-142,-0.08462455303933254,68,0.038946162657502864,321,0.2641975308641975,425,0.38253825382538253,CHN,SDN,1262645000,1337705000,1379860000,1411100000,26298773,33739933,38171178,44440486,0.10885125079725037,3.456307836057418
Canada,Vietnam,26,77,201,544,1205,1454,1532,1506,57.92307692307692,175,0.8706467661691543,327,0.2713692946058091,78,0.05364511691884457,CAN,VNM,30685730,34005902,35704498,38028638,79001142,87411012,92191398,96648685,4.0285429102141395,1.5851224463116078
Mongolia,Canada,24,76,129,607,1035,1411,1528,1504,62.666666666666664,105,0.813953488372093,493,0.47632850241545893,117,0.08291991495393337,MNG,CAN,2450979,2702520,2964749,3294335,30685730,34005902,35704498,38028638,46.38265385882128,4.018024521414624
Bangladesh,Cyprus,162,229,296,1569,683,626,1526,1364,8.419753086419753,134,0.4527027027027027,843,1.2342606149341142,900,1.4376996805111821,BGD,CYP,129193327,148391139,157830000,167420951,948237,1129686,1187280,1237537,0.9114749324294544,123.30944448529618
Iran,Romania,853,875,899,937,1144,1261,1516,663,0.7772567409144197,46,0.05116796440489433,372,0.32517482517482516,255,0.20222045995241872,IRN,ROU,65544383,75373855,81790841,87290193,22442971,20246871,19815616,19265250,1.7367357636613312,7.869090720338433
Nepal,France,707,730,753,1007,1244,1377,1512,805,1.1386138613861385,46,0.06108897742363878,268,0.21543408360128619,135,0.09803921568627451,NPL,FRA,24559500,27161567,27610325,29348627,60921384,65030575,66548272,67571107,5.151859403848773,2.2376427842154487
Cambodia,Belgium,986,980,950,1277,1384,1444,1502,516,0.5233265720081136,-36,-0.037894736842105266,118,0.08526011560693642,58,0.04016620498614958,KHM,BEL,12118841,14363532,15417523,16396860,10251250,10895586,11274196,11538604,9.160290445853658,13.017172614642117
Thailand,Iceland,83,322,560,822,1062,1196,1500,1417,17.072289156626507,477,0.8517857142857143,438,0.4124293785310734,304,0.25418060200668896,THA,ISL,63066603,68270489,70294397,71475664,281205,318041,330815,366463,2.0986163906081376,409.31826678273114
Australia,Thailand,593,991,1595,1402,1310,1405,1470,877,1.478920741989882,1002,0.6282131661442006,160,0.12213740458015267,65,0.046263345195729534,AUS,THA,19028802,22031750,23815995,25649248,63066603,68270489,70294397,71475664,5.731162176762453,2.0566440627959746
Indonesia,South Africa,1191,742,512,673,979,1262,1465,274,0.23005877413937867,-679,-1.326171875,486,0.4964249233912155,203,0.16085578446909668,IDN,ZAF,214072421,244016173,259091970,271857970,46813266,51784921,55876504,58801927,0.5388843299315448,2.4914149497175493
Philippines,Papua New Guinea,2005,2054,1537,1697,1439,1459,1463,-542,-0.27032418952618453,-468,-0.30448926480156147,24,0.01667824878387769,4,0.0027416038382453737,PHL,PNG,77958223,94636700,103031365,112190977,5508297,7583269,8682174,9749640,1.3040264369923438,15.005682261088614
Iran,Azerbaijan,2088,1832,1846,1752,1604,1530,1460,-628,-0.3007662835249042,-242,-0.13109425785482123,-144,-0.08977556109725686,-70,-0.0457516339869281,IRN,AZE,65544383,75373855,81790841,87290193,8048600,9054332,9649341,10093121,1.6725819359799101,14.465297701275949
Bangladesh,Thailand,725,1211,1949,1567,1299,1393,1458,733,1.0110344827586206,1224,0.6280143663417137,159,0.12240184757505773,65,0.046661880832735106,BGD,THA,129193327,148391139,157830000,167420951,63066603,68270489,70294397,71475664,0.8708587493329911,2.0398551316711098
Zambia,India,1008,920,831,1304,1666,1552,1451,443,0.439484126984127,-177,-0.21299638989169675,-215,-0.1290516206482593,-101,-0.06507731958762887,ZMB,IND,9891136,13792086,16248230,18927715,1059633675,1240613620,1322866505,1396387127,7.666007228025148,0.10391101235066028
India,South Sudan,0,0,0,0,1364,1414,1449,1449,1,0,0,85,0.062316715542521994,35,0.024752475247524754,IND,SSD,1059633675,1240613620,1322866505,1396387127,6114440,9714419,11194299,10606227,0.10376778559345742,13.661785666099735
South Korea,Northern Mariana Islands,2422,1938,1573,1855,1604,1436,1448,-974,-0.40214698596201487,-849,-0.5397329942784488,-156,-0.09725685785536159,12,0.008356545961002786,KOR,MNP,47008111,49554112,51014947,51836239,80338,54087,51514,49587,2.793412539054,2920.120192792466
Philippines,Malta,94,110,139,165,391,664,1445,1351,14.372340425531915,45,0.3237410071942446,1054,2.6956521739130435,781,1.1762048192771084,PHL,MLT,77958223,94636700,103031365,112190977,390087,414508,445053,515332,1.2879823659972227,280.40176041852635
Indonesia,North Korea,845,904,963,1124,1284,1414,1444,599,0.7088757396449704,118,0.122533748701973,160,0.12461059190031153,30,0.021216407355021217,IDN,PRK,214072421,244016173,259091970,271857970,23367059,24686435,25258015,25867467,0.5311597081373042,5.582301506367052
Indonesia,Austria,669,755,841,932,1035,1202,1442,773,1.155455904334828,172,0.20451843043995244,407,0.3932367149758454,240,0.19966722129783693,IDN,AUT,214072421,244016173,259091970,271857970,8011566,8363404,8642699,8916864,0.530424029871186,16.17160472560757
Papua New Guinea,United Kingdom,147,580,1023,1003,1058,1266,1428,1281,8.714285714285714,876,0.8563049853372434,370,0.3497164461247637,162,0.12796208530805686,PNG,GBR,5508297,7583269,8682174,9749640,58892514,62766365,65116219,67081234,14.646694647186973,2.1287622705330675
Thailand,Czechia,8,12,16,279,515,864,1418,1410,176.25,8,0.5,903,1.7533980582524271,554,0.6412037037037037,THA,CZE,63066603,68270489,70294397,71475664,10255063,10474410,10546059,10697858,1.9838920279215595,13.254989924151172
Indonesia,Algeria,1000,1223,1446,1143,1255,1363,1416,416,0.416,446,0.3084370677731674,161,0.12828685258964143,53,0.03888481291269259,IDN,DZA,214072421,244016173,259091970,271857970,30774621,35856344,39543154,43451666,0.5208602124116501,3.2587933452309974
Saudi Arabia,Sri Lanka,15,167,321,635,1280,1397,1416,1401,93.4,306,0.9532710280373832,136,0.10625,19,0.013600572655690766,SAU,LKA,21547390,29411929,32749848,35997107,18776371,20668557,21336697,21919000,3.933649445773517,6.460148729412838
Pakistan,Mozambique,516,711,828,1139,1298,1345,1412,896,1.7364341085271318,312,0.37681159420289856,114,0.08782742681047766,67,0.04981412639405204,PAK,MOZ,154369924,194454498,210969298,227196741,17768505,23073723,26843246,31178239,0.6214877879784376,4.5287997182906965
Maldives,Sri Lanka,17,193,370,731,1474,1390,1408,1391,81.82352941176471,353,0.9540540540540541,-66,-0.04477611940298507,18,0.012949640287769784,MDV,LKA,282507,361575,435582,514438,18776371,20668557,21336697,21919000,273.696733134022,6.423650713992426
Thailand,Hungary,631,559,487,599,715,762,1408,777,1.231378763866878,-144,-0.29568788501026694,693,0.9692307692307692,646,0.847769028871391,THA,HUN,63066603,68270489,70294397,71475664,10210971,10000023,9843028,9750149,1.9699012519841719,14.44080495590375
Bangladesh,Fiji,1368,1334,1287,1235,1326,1366,1398,30,0.021929824561403508,-81,-0.06293706293706294,72,0.05429864253393665,32,0.02342606149341142,BGD,FJI,129193327,148391139,157830000,167420951,832509,905169,917200,920422,0.8350209407184648,151.88685190054127
Spain,Philippines,257,345,83,67,1284,1305,1388,1131,4.400778210116732,-174,-2.0963855421686746,104,0.08099688473520249,83,0.06360153256704981,ESP,PHL,40567864,46576897,46444832,47365655,77958223,94636700,103031365,112190977,2.9303933409133682,1.2371761411793392
Cambodia,Italy,41,167,292,807,1299,1315,1385,1344,32.78048780487805,251,0.8595890410958904,86,0.06620477290223249,70,0.053231939163498096,KHM,ITA,12118841,14363532,15417523,16396860,56942108,59277417,60730582,59438851,8.446739192747879,2.3301257960050403
Pakistan,Cyprus,129,183,236,1409,544,499,1374,1245,9.651162790697674,107,0.4533898305084746,830,1.525735294117647,875,1.7535070140280562,PAK,CYP,154369924,194454498,210969298,227196741,948237,1129686,1187280,1237537,0.6047621959506893,111.02698343564677
France,Thailand,1349,1220,1343,1237,1220,1308,1369,20,0.014825796886582653,-6,-0.004467609828741623,149,0.1221311475409836,61,0.046636085626911315,FRA,THA,60921384,65030575,66548272,67571107,63066603,68270489,70294397,71475664,2.0260138700998342,1.9153372258283603
Malaysia,Thailand,1293,1170,1290,1209,1216,1304,1364,71,0.05491105955143078,-3,-0.002325581395348837,148,0.12171052631578948,60,0.046012269938650305,MYS,THA,22945150,28717731,31068833,33199993,63066603,68270489,70294397,71475664,4.10843460117597,1.9083418378596664
Tonga,Fiji,1221,1203,1199,1204,1293,1332,1362,141,0.11547911547911548,-22,-0.01834862385321101,69,0.05336426914153132,30,0.02252252252252252,TON,FJI,102603,107383,106122,105254,832509,905169,917200,920422,1294.0125790943812,147.97560249537713
Philippines,Thailand,1266,1146,1264,1195,1213,1301,1361,95,0.0750394944707741,-2,-0.0015822784810126582,148,0.12201154163231658,60,0.04611837048424289,PHL,THA,77958223,94636700,103031365,112190977,63066603,68270489,70294397,71475664,1.2131100346866575,1.9041446050784503
Thailand,Bahrain,294,323,353,591,960,1040,1347,1053,3.5816326530612246,59,0.1671388101983003,387,0.403125,307,0.2951923076923077,THA,BHR,63066603,68270489,70294397,71475664,711442,1213645,1362142,1477469,1.8845575187661077,91.16942555139904
Bangladesh,Brunei Darussalam,659,908,1156,1182,1208,1234,1343,684,1.0379362670713201,497,0.42993079584775085,135,0.11175496688741722,109,0.08833063209076175,BGD,BRN,129193327,148391139,157830000,167420951,333926,396053,421437,441725,0.8021696161551489,304.0353160903277
Sri Lanka,Brunei Darussalam,676,916,1156,1182,1208,1234,1343,667,0.9866863905325444,480,0.41522491349480967,135,0.11175496688741722,109,0.08833063209076175,LKA,BRN,18776371,20668557,21336697,21919000,333926,396053,421437,441725,6.1271043387015824,304.0353160903277
Bangladesh,Libya,318,613,919,1014,1113,1246,1334,1016,3.1949685534591197,601,0.6539717083786725,221,0.1985624438454627,88,0.07062600321027288,BGD,LBY,129193327,148391139,157830000,167420951,5154790,6491988,6192235,6653942,0.79679394486297,20.048266125553845
Bangladesh,Norway,558,492,485,553,704,997,1331,773,1.385304659498208,-73,-0.15051546391752577,627,0.890625,334,0.3350050150451354,BGD,NOR,129193327,148391139,157830000,167420951,4490967,4889252,5188607,5379475,0.7950020544322437,24.742191384847036
Vietnam,India,2832,1762,692,1161,1520,1416,1324,-1508,-0.5324858757062146,-2140,-3.092485549132948,-196,-0.12894736842105264,-92,-0.06497175141242938,VNM,IND,79001142,87411012,92191398,96648685,1059633675,1240613620,1322866505,1396387127,1.3699099992927997,0.09481611326827993
India,Fiji,1443,1374,1292,1169,1255,1292,1321,-122,-0.08454608454608455,-151,-0.11687306501547988,66,0.05258964143426295,29,0.02244582043343653,IND,FJI,1059633675,1240613620,1322866505,1396387127,832509,905169,917200,920422,0.09460127313247567,143.52112400616238
Iraq,Malaysia,32,72,138,351,686,1244,1318,1286,40.1875,106,0.7681159420289855,632,0.9212827988338192,74,0.0594855305466238,IRQ,MYS,24628858,31264875,37757813,42556984,22945150,28717731,31068833,33199993,3.097023980834732,3.9698803550952557
Indonesia,India,1786,1394,1002,1291,1512,1408,1316,-470,-0.2631578947368421,-784,-0.782435129740519,-196,-0.12962962962962962,-92,-0.06534090909090909,IDN,IND,214072421,244016173,259091970,271857970,1059633675,1240613620,1322866505,1396387127,0.48407629910574257,0.09424320623946858
India,Lebanon,398,1169,1940,1854,1779,1503,1311,913,2.2939698492462313,1542,0.7948453608247422,-468,-0.2630691399662732,-192,-0.1277445109780439,IND,LBN,1059633675,1240613620,1322866505,1396387127,4320642,4995800,6398940,5662923,0.09388513934646148,23.150588485840263
Mongolia,United Kingdom,40,162,288,915,966,1156,1302,1262,31.55,248,0.8611111111111112,336,0.34782608695652173,146,0.12629757785467127,MNG,GBR,2450979,2702520,2964749,3294335,58892514,62766365,65116219,67081234,39.522392227869965,1.940930305486032
Afghanistan,Philippines,25,33,781,632,1201,1220,1297,1272,50.88,756,0.967989756722151,96,0.07993338884263114,77,0.06311475409836066,AFG,PHL,19542982,28189672,33753499,38972230,77958223,94636700,103031365,112190977,3.328010739955091,1.1560644489262268
Indonesia,Denmark,422,528,633,866,1050,1135,1294,872,2.066350710900474,211,0.3333333333333333,244,0.23238095238095238,159,0.14008810572687225,IDN,DNK,214072421,244016173,259091970,271857970,5339616,5547683,5683483,5831404,0.475983838178443,22.190196391812332
India,Latvia,35,54,74,89,102,131,1290,1255,35.857142857142854,39,0.527027027027027,1188,11.647058823529411,1159,8.84732824427481,IND,LVA,1059633675,1240613620,1322866505,1396387127,2367550,2097555,1977527,1900449,0.09238125839583167,67.87869603446343
Nepal,Czechia,4,6,8,59,105,182,1286,1282,320.5,4,0.5,1181,11.247619047619047,1104,6.065934065934066,NPL,CZE,24559500,27161567,27610325,29348627,10255063,10474410,10546059,10697858,4.381806344807885,12.021098055330329
France,Philippines,197,265,365,295,1186,1204,1280,1083,5.49746192893401,168,0.4602739726027397,94,0.07925801011804384,76,0.06312292358803986,FRA,PHL,60921384,65030575,66548272,67571107,77958223,94636700,103031365,112190977,1.8943007697062,1.1409117152086126
Myanmar,Netherlands,86,126,171,359,696,1110,1262,1176,13.674418604651162,85,0.49707602339181284,566,0.8132183908045977,152,0.13693693693693693,MMR,NLD,45538332,49390988,51483949,53423198,15925513,16615394,16939923,17441500,2.3622696642009338,7.235616202734857
China,Aruba,247,435,622,855,1072,1127,1260,1013,4.101214574898785,375,0.6028938906752411,188,0.17537313432835822,133,0.11801242236024845,CHN,ABW,1262645000,1337705000,1379860000,1411100000,89101,100341,104257,106585,0.08929204166961945,1182.1550874888587
China,Slovakia,49,320,681,764,856,1074,1256,1207,24.632653061224488,632,0.9280469897209985,400,0.4672897196261682,182,0.16945996275605213,CHN,SVK,1262645000,1337705000,1379860000,1411100000,5388720,5391428,5423801,5458827,0.08900857487066827,23.008606061338817
Cambodia,United Kingdom,97,385,680,883,931,1113,1255,1158,11.938144329896907,583,0.8573529411764705,324,0.34801288936627284,142,0.1275831087151842,KHM,GBR,12118841,14363532,15417523,16396860,58892514,62766365,65116219,67081234,7.653904467074795,1.8708660010637252
China,Bolivia (Plurinational State of),805,675,538,754,968,1128,1254,449,0.5577639751552795,-267,-0.4962825278810409,286,0.29545454545454547,126,0.11170212765957446,CHN,BOL,1262645000,1337705000,1379860000,1411100000,8592656,10223270,11090085,11936162,0.08886684147119268,10.505889581592475
India,Egypt,801,823,910,1083,1165,800,1249,448,0.5593008739076155,109,0.11978021978021978,84,0.07210300429184549,449,0.56125,IND,EGY,1059633675,1240613620,1322866505,1396387127,71371371,87252413,97723799,107465134,0.08944510987317345,1.162237419254509
Russian Federation,India,3445,2547,1649,1526,1433,1335,1248,-2197,-0.6377358490566037,-1796,-1.0891449363250454,-185,-0.12909979064898813,-87,-0.0651685393258427,RUS,IND,146596869,142849468,144640716,145245148,1059633675,1240613620,1322866505,1396387127,0.8592369639776194,0.08937349649457202
China,Zambia,100,128,166,408,1007,887,1241,1141,11.41,66,0.39759036144578314,234,0.2323733862959285,354,0.399098083427283,CHN,ZMB,1262645000,1337705000,1379860000,1411100000,9891136,13792086,16248230,18927715,0.08794557437460138,6.556523066836119
Myanmar,Finland,7,29,50,504,834,1118,1216,1209,172.71428571428572,43,0.86,382,0.4580335731414868,98,0.08765652951699464,MMR,FIN,45538332,49390988,51483949,53423198,5176209,5363352,5479531,5529543,2.276164747756209,21.990967427145424
China,Puerto Rico,339,826,1315,1422,1351,1088,1212,873,2.575221238938053,976,0.7422053231939163,-139,-0.10288675055514433,124,0.11397058823529412,CHN,PRI,1262645000,1337705000,1379860000,1411100000,3810605,3721525,3473232,3281557,0.08589044008220538,36.9336872710119
Pakistan,Nepal,2371,2734,2470,2156,1296,1268,1212,-1159,-0.48882328131590047,99,0.04008097165991903,-84,-0.06481481481481481,-56,-0.04416403785488959,PAK,NPL,154369924,194454498,210969298,227196741,24559500,27161567,27610325,29348627,0.5334583562534464,4.129665077688302
Iran,Tajikistan,1813,1473,1267,1221,1218,1197,1200,-613,-0.33811362382790955,-546,-0.430939226519337,-18,-0.014778325123152709,3,0.002506265664160401,IRN,TJK,65544383,75373855,81790841,87290193,6272998,7621779,8524063,9543207,1.3747248788875974,12.574389301206606
Philippines,Bahamas,64,103,143,587,1031,1117,1196,1132,17.6875,79,0.5524475524475524,165,0.1600387972841901,79,0.07072515666965085,PHL,BHS,77958223,94636700,103031365,112190977,325014,373272,392697,406471,1.0660393838980473,294.239933476189
Iran,Cyprus,299,423,547,1128,1262,1158,1194,895,2.9933110367892977,248,0.453382084095064,-68,-0.05388272583201268,36,0.031088082901554404,IRN,CYP,65544383,75373855,81790841,87290193,948237,1129686,1187280,1237537,1.3678512544931594,96.48196377158824
United Kingdom,Sri Lanka,48,182,317,594,1163,1177,1192,1144,23.833333333333332,269,0.8485804416403786,29,0.024935511607910577,15,0.012744265080713678,GBR,LKA,58892514,62766365,65116219,67081234,18776371,20668557,21336697,21919000,1.7769500185402074,5.438204297641316
Sri Lanka,South Africa,963,600,415,545,793,1022,1186,223,0.23156801661474558,-548,-1.3204819277108433,393,0.49558638083228246,164,0.16046966731898238,LKA,ZAF,18776371,20668557,21336697,21919000,46813266,51784921,55876504,58801927,5.410830786076007,2.016940703320828
North Korea,Guinea,0,0,0,0,0,1232,1183,1183,1,0,0,1183,1,-49,-0.03977272727272727,PRK,GIN,23367059,24686435,25258015,25867467,8336967,10270728,11625998,13205153,4.573312106670514,8.958623955360457
United Kingdom,Vietnam,256,1230,3613,2803,927,1119,1178,922,3.6015625,3357,0.929144755051204,251,0.2707659115426106,59,0.05272564789991063,GBR,VNM,58892514,62766365,65116219,67081234,79001142,87411012,92191398,96648685,1.7560798002016482,1.2188474162892127
India,Jamaica,711,962,1213,1183,1152,1127,1148,437,0.6146272855133614,502,0.41384995877988456,-4,-0.003472222222222222,21,0.018633540372670808,IND,JAM,1059633675,1240613620,1322866505,1396387127,2612205,2733896,2794445,2820436,0.08221215863443003,40.702926781533066
Sri Lanka,Finland,159,232,304,511,649,908,1148,989,6.220125786163522,145,0.4769736842105263,499,0.7688751926040062,240,0.2643171806167401,LKA,FIN,18776371,20668557,21336697,21919000,5176209,5363352,5479531,5529543,5.237465212829052,20.76120938023269
Afghanistan,Syrian Arab Republic,0,92,172,629,2605,1487,1143,1143,1,172,1,-1462,-0.5612284069097888,-344,-0.23133826496301277,AFG,SYR,19542982,28189672,33753499,38972230,16307654,22337563,19205178,20772595,2.932857575766129,5.502442039619989
Sri Lanka,Mauritius,9,19,42,496,979,1126,1137,1128,125.33333333333333,33,0.7857142857142857,158,0.16138917262512767,11,0.009769094138543518,LKA,MUS,18776371,20668557,21336697,21919000,1186873,1250400,1262879,1266014,5.187280441625987,89.80943338699257
Laos,Belgium,1032,1032,1002,1204,1150,1149,1136,104,0.10077519379844961,-30,-0.029940119760479042,-14,-0.01217391304347826,-13,-0.011314186248912098,LAO,BEL,5430853,6323418,6787419,7319399,10251250,10895586,11274196,11538604,15.520399967265073,9.84521177778525
India,Poland,436,372,318,594,889,846,1128,692,1.5871559633027523,-118,-0.3710691823899371,239,0.2688413948256468,282,0.3333333333333333,IND,POL,1059633675,1240613620,1322866505,1396387127,38258629,38042794,37986412,37899070,0.08077989106240163,2.9763263320181736
Philippines,Aruba,217,486,754,863,955,1004,1121,904,4.1658986175115205,537,0.7122015915119363,166,0.17382198952879582,117,0.11653386454183266,PHL,ABW,77958223,94636700,103031365,112190977,89101,100341,104257,106585,0.9991890880850427,1051.7427405357225
India,Brazil,697,730,762,824,875,1030,1118,421,0.6040172166427547,65,0.08530183727034121,243,0.2777142857142857,88,0.0854368932038835,IND,BRA,1059633675,1240613620,1322866505,1396387127,175873720,196353492,205188205,213196304,0.08006375727638744,0.5243993348027272
Philippines,American Samoa,379,520,661,889,1117,1115,1118,739,1.949868073878628,282,0.4266263237518911,1,8.952551477170994e-4,3,0.0026905829596412557,PHL,ASM,77958223,94636700,103031365,112190977,58230,54849,51368,46189,0.9965150762525224,2420.4897269912753
China,Slovenia,61,132,201,323,732,863,1113,1052,17.24590163934426,140,0.6965174129353234,381,0.5204918032786885,250,0.28968713789107764,CHN,SVN,1262645000,1337705000,1379860000,1411100000,1988925,2048583,2063531,2102419,0.07887463680816384,52.93901929158745
Philippines,Egypt,677,711,801,954,1027,705,1101,424,0.6262924667651403,124,0.15480649188514356,74,0.07205452775073028,396,0.5617021276595745,PHL,EGY,77958223,94636700,103031365,112190977,71371371,87252413,97723799,107465134,0.9813623425349082,1.0245183335462087
Switzerland,Philippines,250,336,369,298,1017,1033,1098,848,3.392,119,0.3224932249322493,81,0.07964601769911504,65,0.06292352371732816,CHE,PHL,7184250,7824909,8282396,8638167,77958223,94636700,103031365,112190977,12.71103001365915,0.9786883307023879
Mongolia,Switzerland,148,303,460,519,608,768,1097,949,6.412162162162162,312,0.6782608695652174,489,0.8042763157894737,329,0.4283854166666667,MNG,CHE,2450979,2702520,2964749,3294335,7184250,7824909,8282396,8638167,33.29958853607784,12.699453483592062
Malaysia,South Africa,889,554,382,503,732,944,1096,207,0.23284589426321708,-507,-1.3272251308900525,364,0.4972677595628415,152,0.16101694915254236,MYS,ZAF,22945150,28717731,31068833,33199993,46813266,51784921,55876504,58801927,3.301205515314416,1.863884494805757
Pakistan,Sri Lanka,173,248,324,482,809,1085,1083,910,5.2601156069364166,151,0.4660493827160494,274,0.33868974042027195,-2,-0.0018433179723502304,PAK,LKA,154369924,194454498,210969298,227196741,18776371,20668557,21336697,21919000,0.4766793727908271,4.9409188375382085
Nepal,Sweden,121,143,154,238,503,844,1080,959,7.925619834710743,33,0.21428571428571427,577,1.1471172962226641,236,0.2796208530805687,NPL,SWE,24559500,27161567,27610325,29348627,8872109,9378126,9799186,10353442,3.679899574177695,10.431313567024377
Thailand,Egypt,967,844,787,937,1008,692,1080,113,0.11685625646328852,-180,-0.22871664548919948,72,0.07142857142857142,388,0.5606936416184971,THA,EGY,63066603,68270489,70294397,71475664,71371371,87252413,97723799,107465134,1.511003801237859,1.0049771119254363
Nepal,Switzerland,353,502,654,725,864,934,1077,724,2.0509915014164304,301,0.4602446483180428,213,0.2465277777777778,143,0.15310492505353318,NPL,CHE,24559500,27161567,27610325,29348627,7184250,7824909,8282396,8638167,3.6696776309160906,12.467922882250367
China,Malta,148,173,220,259,292,495,1076,928,6.27027027027027,72,0.32727272727272727,784,2.684931506849315,581,1.1737373737373737,CHN,MLT,1262645000,1337705000,1379860000,1411100000,390087,414508,445053,515332,0.0762525689178655,208.79743543967774
Iran,Luxembourg,224,212,204,177,152,231,1074,850,3.794642857142857,-20,-0.09803921568627451,922,6.065789473684211,843,3.6493506493506493,IRN,LUX,65544383,75373855,81790841,87290193,436300,506953,569604,630419,1.2303787666043997,170.36288563637834
Guam,Philippines,58,78,1056,854,992,1008,1071,1013,17.46551724137931,998,0.9450757575757576,79,0.07963709677419355,63,0.0625,GUM,PHL,160188,164905,167978,169231,77958223,94636700,103031365,112190977,632.8627733689453,0.9546222242097063
Bangladesh,Myanmar,1370,1557,1359,1154,1065,1024,1066,-304,-0.22189781021897811,-11,-0.008094186902133923,1,9.389671361502347e-4,42,0.041015625,BGD,MMR,129193327,148391139,157830000,167420951,45538332,49390988,51483949,53423198,0.6367183997180854,1.9953878463060184
India,Trinidad and Tobago,768,697,620,665,926,959,1064,296,0.3854166666666667,-148,-0.23870967741935484,138,0.1490280777537797,105,0.10948905109489052,IND,TTO,1059633675,1240613620,1322866505,1396387127,1332203,1410296,1460177,1518147,0.07619663483191076,70.08543968403586
Netherlands,Hong Kong,683,763,842,919,999,1020,1063,380,0.5563689604685212,159,0.18883610451306412,64,0.06406406406406406,43,0.04215686274509804,NLD,HKG,15925513,16615394,16939923,17441500,6665000,7024200,7291300,7481000,6.0946592896253184,14.209330303435369
Pakistan,Hungary,205,182,158,194,232,3677,1055,850,4.146341463414634,-47,-0.2974683544303797,823,3.5474137931034484,-2622,-0.7130813162904541,PAK,HUN,154369924,194454498,210969298,227196741,10210971,10000023,9843028,9750149,0.4643552523493284,10.820347463407996
Thailand,South Africa,151,225,368,484,704,908,1054,903,5.9801324503311255,217,0.5896739130434783,350,0.4971590909090909,146,0.16079295154185022,THA,ZAF,63066603,68270489,70294397,71475664,46813266,51784921,55876504,58801927,1.4746277838006514,1.7924582641653903
United States of America,North Korea,672,661,649,792,934,1028,1049,377,0.5610119047619048,-23,-0.03543913713405239,115,0.12312633832976445,21,0.020428015564202335,USA,PRK,282162411,309327143,320738994,331526933,23367059,24686435,25258015,25867467,0.3164147149396155,4.055286897630912
Cambodia,Vietnam,21150,34400,15945,2357,1928,990,1043,-20107,-0.9506855791962175,-5205,-0.3264346190028222,-885,-0.45902489626556015,53,0.05353535353535353,KHM,VNM,12118841,14363532,15417523,16396860,79001142,87411012,92191398,96648685,6.36097399136176,1.079166260772198
Laos,Switzerland,724,720,720,796,951,961,1013,289,0.39917127071823205,-4,-0.005555555555555556,62,0.06519453207150368,52,0.054110301768990635,LAO,CHE,5430853,6323418,6787419,7319399,7184250,7824909,8282396,8638167,13.839934125739012,11.727024957956937
India,Ghana,454,452,506,712,708,871,999,545,1.2004405286343611,52,0.10276679841897234,291,0.4110169491525424,128,0.14695752009184845,IND,GHA,1059633675,1240613620,1322866505,1396387127,19665502,25574719,28870939,32180401,0.07154176522281847,3.1043739945937903
Pakistan,Uganda,216,204,594,572,630,1004,995,779,3.6064814814814814,378,0.6363636363636364,365,0.5793650793650794,-9,-0.008964143426294821,PAK,UGA,154369924,194454498,210969298,227196741,24020697,32341728,37477356,44404611,0.43794642283183105,2.2407582852150196
Indonesia,New Caledonia,819,949,1079,1150,1221,938,994,175,0.21367521367521367,260,0.24096385542168675,-227,-0.18591318591318592,56,0.05970149253731343,IDN,NCL,214072421,244016173,259091970,271857970,213230,249750,269460,271080,0.36563209826072046,366.6814224583149
Philippines,Maldives,303,237,156,525,717,910,991,688,2.2706270627062706,-147,-0.9423076923076923,274,0.3821478382147838,81,0.08901098901098901,PHL,MDV,77958223,94636700,103031365,112190977,282507,361575,435582,514438,0.883315242009168,192.63740236918736
Armenia,Iran,571,575,1287,1867,1517,1185,989,418,0.7320490367775832,716,0.5563325563325563,-528,-0.34805537244561635,-196,-0.16540084388185655,ARM,IRN,3168523,2946293,2878595,2805608,65544383,75373855,81790841,87290193,35.250826202377525,1.1330024210165281
Sri Lanka,Botswana,398,480,613,1028,853,926,988,590,1.4824120603015076,215,0.35073409461663946,135,0.15826494724501758,62,0.06695464362850972,LKA,BWA,18776371,20668557,21336697,21919000,1726985,2091664,2305171,2546402,4.507504904420822,38.799843858118244
South Korea,Luxembourg,49,46,44,37,32,48,983,934,19.06122448979592,-5,-0.11363636363636363,951,29.71875,935,19.479166666666668,KOR,LUX,47008111,49554112,51014947,51836239,436300,506953,569604,630419,1.896356716774919,155.92804150890123
Switzerland,Thailand,370,619,997,901,870,933,976,606,1.6378378378378378,627,0.6288866599799399,106,0.12183908045977011,43,0.04608788853161844,CHE,THA,7184250,7824909,8282396,8638167,63066603,68270489,70294397,71475664,11.298693345474797,1.3654997314890283
Sri Lanka,Austria,540,610,679,752,836,852,973,433,0.8018518518518518,139,0.20471281296023564,137,0.1638755980861244,121,0.142018779342723,LKA,AUT,18776371,20668557,21336697,21919000,8011566,8363404,8642699,8916864,4.43907112550755,10.911908043007047
China,Trinidad and Tobago,469,425,461,494,836,866,961,492,1.049040511727079,-8,-0.01735357917570499,125,0.14952153110047847,95,0.10969976905311778,CHN,TTO,1262645000,1337705000,1379860000,1411100000,1332203,1410296,1460177,1518147,0.06810289844801927,63.30085294770532
India,Sierra Leone,405,395,385,341,539,855,959,554,1.3679012345679011,-20,-0.05194805194805195,420,0.7792207792207793,104,0.1216374269005848,IND,SLE,1059633675,1240613620,1322866505,1396387127,4584067,6436698,7314773,8233970,0.06867723007876168,11.646872650738343
China,Bhutan,422,496,570,714,858,906,949,527,1.2488151658767772,148,0.2596491228070175,91,0.10606060606060606,43,0.04746136865342163,CHN,BTN,1262645000,1337705000,1379860000,1411100000,587207,705516,743274,772506,0.06725249805116576,122.84694228912139
China,Fiji,848,835,833,836,898,925,946,98,0.11556603773584906,-15,-0.01800720288115246,48,0.053452115812917596,21,0.022702702702702703,CHN,FJI,1262645000,1337705000,1379860000,1411100000,832509,905169,917200,920422,0.06703989795195238,102.77894270236912
South Korea,Thailand,469,784,1262,1015,841,902,944,475,1.0127931769722816,793,0.6283676703645008,103,0.12247324613555291,42,0.04656319290465632,KOR,THA,47008111,49554112,51014947,51836239,63066603,68270489,70294397,71475664,1.8211197768418346,1.320729248489388
China,Timor-Leste,928,1012,1104,1172,1196,953,938,10,0.010775862068965518,176,0.15942028985507245,-258,-0.2157190635451505,-15,-0.015739769150052464,CHN,TLS,1262645000,1337705000,1379860000,1411100000,878360,1088486,1205813,1299995,0.06647296435405003,72.15412366970642
Malaysia,Norway,182,230,304,366,590,836,934,752,4.131868131868132,122,0.40131578947368424,344,0.5830508474576271,98,0.11722488038277512,MYS,NOR,22945150,28717731,31068833,33199993,4490967,4889252,5188607,5379475,2.813253605204073,17.362289070959527
Turkey,Philippines,202,271,922,746,866,879,934,732,3.623762376237624,720,0.7809110629067245,68,0.07852193995381063,55,0.06257110352673492,TUR,PHL,64113547,73142150,78218479,83384680,77958223,94636700,103031365,112190977,1.1201098331252215,0.8325090171912845
Malaysia,Sri Lanka,22,128,235,453,901,912,925,903,41.04545454545455,213,0.9063829787234042,24,0.026637069922308545,13,0.01425438596491228,MYS,LKA,22945150,28717731,31068833,33199993,18776371,20668557,21336697,21919000,2.786145165753499,4.220083032985081
Indonesia,Brazil,0,0,0,361,723,851,924,924,1,0,0,201,0.27800829875518673,73,0.08578143360752057,IDN,BRA,214072421,244016173,259091970,271857970,175873720,196353492,205188205,213196304,0.3398833589465852,0.43340338582980314
China,Congo,283,327,459,292,695,924,917,634,2.2402826855123674,176,0.38344226579520696,222,0.3194244604316547,-7,-0.007575757575757576,CHN,COG,1262645000,1337705000,1379860000,1411100000,3134030,4437884,5064386,5702174,0.06498476365955637,16.081585725023473
Vietnam,Iceland,76,148,220,355,480,613,916,840,11.052631578947368,144,0.6545454545454545,436,0.9083333333333333,303,0.49429037520391517,VNM,ISL,79001142,87411012,92191398,96648685,281205,318041,330815,366463,0.9477625070635984,249.95702158198782
Sri Lanka,Greece,1344,1069,811,860,941,886,904,-440,-0.3273809523809524,-533,-0.657213316892725,-37,-0.039319872476089264,18,0.020316027088036117,LKA,GRC,18776371,20668557,21336697,21919000,10805808,11121341,10820883,10698599,4.1242757425065015,8.44970448934482
Nigeria,India,1286,1038,790,930,1037,966,903,-383,-0.2978227060653188,-496,-0.6278481012658228,-134,-0.12921890067502412,-63,-0.06521739130434782,NGA,IND,122851984,160952853,183995785,208327405,1059633675,1240613620,1322866505,1396387127,0.43345233431962543,0.06466688087708217
Malaysia,Denmark,298,351,404,553,670,821,902,604,2.0268456375838926,106,0.2623762376237624,232,0.34626865671641793,81,0.09866017052375152,MYS,DNK,22945150,28717731,31068833,33199993,5339616,5547683,5683483,5831404,2.7168680427131418,15.467973064462694
Iran,Czechia,47,70,93,212,310,502,896,849,18.06382978723404,46,0.4946236559139785,586,1.8903225806451613,394,0.7848605577689243,IRN,CZE,65544383,75373855,81790841,87290193,10255063,10474410,10546059,10697858,1.0264612429027393,8.375508442905113
Pakistan,Brunei Darussalam,378,574,770,787,804,821,893,515,1.3624338624338623,392,0.509090909090909,89,0.11069651741293532,72,0.0876979293544458,PAK,BRN,154369924,194454498,210969298,227196741,333926,396053,421437,441725,0.39305141265208554,202.16197860659915
Philippines,Luxembourg,183,173,166,144,124,189,891,708,3.8688524590163933,-17,-0.10240963855421686,767,6.185483870967742,702,3.7142857142857144,PHL,LUX,77958223,94636700,103031365,112190977,436300,506953,569604,630419,0.794181514258495,141.3345727206826
Cambodia,Austria,528,596,663,735,816,815,886,358,0.678030303030303,135,0.20361990950226244,70,0.0857843137254902,71,0.08711656441717791,KHM,AUT,12118841,14363532,15417523,16396860,8011566,8363404,8642699,8916864,5.403473591895033,9.936228701032112
India,Sint Maarten (Dutch part),0,0,0,411,801,834,880,880,1,0,0,79,0.0986267166042447,46,0.05515587529976019,IND,SXM,1059633675,1240613620,1322866505,1396387127,30519,34056,38825,40350,0.0630197731692495,2180.9169764560097
Singapore,Philippines,133,178,231,186,807,820,871,738,5.548872180451128,98,0.42424242424242425,64,0.07930607187112763,51,0.06219512195121951,SGP,PHL,4027887,5076732,5535002,5685807,77958223,94636700,103031365,112190977,15.318845680129488,0.7763547687083606
Maldives,India,1810,1027,243,667,992,924,864,-946,-0.5226519337016574,-1567,-6.448559670781893,-128,-0.12903225806451613,-60,-0.06493506493506493,MDV,IND,282507,361575,435582,514438,1059633675,1240613620,1322866505,1396387127,167.9502680595135,0.06187395911162678
South Africa,Philippines,186,250,852,689,800,813,864,678,3.6451612903225805,666,0.7816901408450704,64,0.08,51,0.06273062730627306,ZAF,PHL,46813266,51784921,55876504,58801927,77958223,94636700,103031365,112190977,1.4693396017446845,0.7701154077658134
Afghanistan,Bahrain,215,236,258,392,613,664,860,645,3,43,0.16666666666666666,247,0.4029363784665579,196,0.29518072289156627,AFG,BHR,19542982,28189672,33753499,38972230,711442,1213645,1362142,1477469,2.206699488327971,58.207651057314905
Malaysia,Algeria,1651,1264,877,694,762,827,859,-792,-0.47970926711084194,-774,-0.8825541619156214,97,0.1272965879265092,32,0.03869407496977025,MYS,DZA,22945150,28717731,31068833,33199993,30774621,35856344,39543154,43451666,2.587349943115952,1.9769092397976178
United States of America,Mongolia,247,272,301,447,646,799,856,609,2.465587044534413,54,0.17940199335548174,210,0.32507739938080493,57,0.07133917396745933,USA,MNG,282162411,309327143,320738994,331526933,2450979,2702520,2964749,3294335,0.25819923354462426,25.983999805727105
Philippines,Lebanon,1026,1572,2117,1626,1157,978,853,-173,-0.16861598440545808,1091,0.5153519130845536,-304,-0.2627484874675886,-125,-0.1278118609406953,PHL,LBN,77958223,94636700,103031365,112190977,4320642,4995800,6398940,5662923,0.7603106977132394,15.062892432053198
Japan,Sri Lanka,9,107,207,410,828,838,848,839,93.22222222222223,198,0.9565217391304348,20,0.024154589371980676,10,0.011933174224343675,JPN,LKA,126843000,128070000,127141000,126261000,18776371,20668557,21336697,21919000,0.6716246505254988,3.868789634563621
Iran,South Africa,680,424,295,389,566,730,847,167,0.24558823529411763,-385,-1.305084745762712,281,0.49646643109540634,117,0.16027397260273973,IRN,ZAF,65544383,75373855,81790841,87290193,46813266,51784921,55876504,58801927,0.9703266436814958,1.4404289845807263
South Korea,Ecuador,270,303,336,403,640,810,846,576,2.1333333333333333,66,0.19642857142857142,206,0.321875,36,0.044444444444444446,KOR,ECU,47008111,49554112,51014947,51836239,12626507,14989585,16195902,17588595,1.6320628508561357,4.809935074404749
Sri Lanka,Spain,45,69,838,403,565,628,846,801,17.8,793,0.9463007159904535,281,0.49734513274336284,218,0.3471337579617834,LKA,ESP,18776371,20668557,21336697,21919000,40567864,46576897,46444832,47365655,3.8596651307085175,1.7861042985682347
China,Paraguay,1953,1419,882,840,800,780,844,-1109,-0.5678443420378905,-1071,-1.2142857142857142,44,0.055,64,0.08205128205128205,CHN,PRY,1262645000,1337705000,1379860000,1411100000,5123819,5768613,6177950,6618695,0.059811494578697465,12.751758465981588
Mongolia,Belgium,47,47,45,164,437,778,844,797,16.95744680851064,-2,-0.044444444444444446,407,0.931350114416476,66,0.08483290488431877,MNG,BEL,2450979,2702520,2964749,3294335,10251250,10895586,11274196,11538604,25.61973812620757,7.3145763560305905
Vanuatu,France,127,132,136,678,694,769,843,716,5.637795275590551,9,0.0661764705882353,149,0.21469740634005763,74,0.09622886866059818,VUT,FRA,192074,245453,276438,311685,60921384,65030575,66548272,67571107,270.46537369459554,1.2475746475486926
Malaysia,Philippines,245,329,316,255,781,793,842,597,2.436734693877551,71,0.22468354430379747,61,0.07810499359795134,49,0.0617906683480454,MYS,PHL,22945150,28717731,31068833,33199993,77958223,94636700,103031365,112190977,2.536145113042644,0.7505059876606655
North Korea,Canada,106,106,109,355,340,775,838,732,6.90566037735849,3,0.027522935779816515,498,1.464705882352941,63,0.08129032258064516,PRK,CAN,23367059,24686435,25258015,25867467,30685730,34005902,35704498,38028638,3.239590486381987,2.2036024534983345
Cambodia,Netherlands,261,384,522,631,676,733,821,560,2.1455938697318007,261,0.5,145,0.21449704142011836,88,0.12005457025920874,KHM,NLD,12118841,14363532,15417523,16396860,15925513,16615394,16939923,17441500,5.00705622905849,4.7071639480549265
Malaysia,Belgium,334,334,324,501,636,719,820,486,1.4550898203592815,-10,-0.030864197530864196,184,0.2893081761006289,101,0.1404728789986092,MYS,BEL,22945150,28717731,31068833,33199993,10251250,10895586,11274196,11538604,2.4698800388301287,7.106578924105551
Sri Lanka,Hong Kong,524,585,646,705,766,782,815,291,0.5553435114503816,122,0.18885448916408668,49,0.0639686684073107,33,0.04219948849104859,LKA,HKG,18776371,20668557,21336697,21919000,6665000,7024200,7291300,7481000,3.718235320954423,10.89426547253041
Malaysia,Spain,41,62,752,362,515,602,811,770,18.78048780487805,711,0.9454787234042553,296,0.574757281553398,209,0.34717607973421927,MYS,ESP,22945150,28717731,31068833,33199993,40567864,46576897,46444832,47365655,2.442771599379554,1.7122110947267595
Philippines,Turkey,141,341,544,564,581,574,801,660,4.680851063829787,403,0.7408088235294118,220,0.37865748709122204,227,0.39547038327526135,PHL,TUR,77958223,94636700,103031365,112190977,64113547,73142150,78218479,83384680,0.7139611592828895,0.9606081117058912
Nepal,Austria,323,365,406,450,500,610,799,476,1.4736842105263157,83,0.2044334975369458,299,0.598,189,0.30983606557377047,NPL,AUT,24559500,27161567,27610325,29348627,8011566,8363404,8642699,8916864,2.7224442220073874,8.960549359057175
Kiribati,Fiji,710,700,698,701,753,775,793,83,0.11690140845070422,-12,-0.017191977077363897,40,0.05312084993359894,18,0.023225806451612905,KIR,FJI,88826,107995,116707,126463,832509,905169,917200,920422,627.0608794667215,86.15613273042148
India,Malta,130,152,194,228,215,364,791,661,5.084615384615384,64,0.32989690721649484,576,2.6790697674418604,427,1.1730769230769231,IND,MLT,1059633675,1240613620,1322866505,1396387127,390087,414508,445053,515332,0.05664618247372313,153.49328200072964
Canada,Thailand,917,826,907,773,695,745,779,-138,-0.1504907306434024,-10,-0.011025358324145534,84,0.12086330935251799,34,0.04563758389261745,CAN,THA,30685730,34005902,35704498,38028638,63066603,68270489,70294397,71475664,2.048456218705492,1.0898814455224928
Fiji,India,2385,1298,210,598,895,833,779,-1606,-0.6733752620545074,-2175,-10.357142857142858,-116,-0.12960893854748604,-54,-0.06482593037214886,FJI,IND,832509,905169,917200,920422,1059633675,1240613620,1322866505,1396387127,84.63509129507986,0.055786821930506096
Saudi Arabia,Philippines,227,305,877,709,722,733,779,552,2.4317180616740086,650,0.7411630558722919,57,0.07894736842105263,46,0.06275579809004093,SAU,PHL,21547390,29411929,32749848,35997107,77958223,94636700,103031365,112190977,2.16406279537964,0.6943517391777415
China,Egypt,479,501,562,669,720,495,771,292,0.6096033402922756,83,0.14768683274021352,51,0.07083333333333333,276,0.5575757575757576,CHN,EGY,1262645000,1337705000,1379860000,1411100000,71371371,87252413,97723799,107465134,0.05463822549783857,0.7174419937912142
Vietnam,North Korea,716,699,681,682,682,751,766,50,0.06983240223463687,-35,-0.0513950073421439,84,0.12316715542521994,15,0.019973368841544607,VNM,PRK,79001142,87411012,92191398,96648685,23367059,24686435,25258015,25867467,0.7925612231558039,2.961248583017425
South Korea,Libya,806,661,527,581,638,713,761,-45,-0.05583126550868486,-279,-0.5294117647058824,123,0.19278996865203762,48,0.06732117812061711,KOR,LBY,47008111,49554112,51014947,51836239,5154790,6491988,6192235,6653942,1.4680849048481315,11.436829476421645
Singapore,Thailand,809,730,803,713,675,724,757,-52,-0.06427688504326329,-6,-0.007471980074719801,82,0.12148148148148148,33,0.04558011049723757,SGP,THA,4027887,5076732,5535002,5685807,63066603,68270489,70294397,71475664,13.313853248975914,1.0591017384602401
Switzerland,Hong Kong,487,544,600,655,711,726,757,270,0.5544147843942505,113,0.18833333333333332,46,0.06469760900140648,31,0.04269972451790634,CHE,HKG,7184250,7824909,8282396,8638167,6665000,7024200,7291300,7481000,8.76343326078322,10.118968052399412
Nepal,Bhutan,334,392,451,565,679,717,751,417,1.248502994011976,117,0.25942350332594233,72,0.10603829160530191,34,0.04741980474198047,NPL,BTN,24559500,27161567,27610325,29348627,587207,705516,743274,772506,2.558893129821712,97.21607340266613
Philippines,Romania,18,15,14,11,47,40,751,733,40.72222222222222,-4,-0.2857142857142857,704,14.97872340425532,711,17.775,PHL,ROU,77958223,94636700,103031365,112190977,22442971,20246871,19815616,19265250,0.6693942954075531,3.8982105085581553
China,Iceland,58,118,177,335,483,582,747,689,11.879310344827585,119,0.672316384180791,264,0.546583850931677,165,0.28350515463917525,CHN,ISL,1262645000,1337705000,1379860000,1411100000,281205,318041,330815,366463,0.052937424704131535,203.8404968578001
Sri Lanka,Romania,1,0,1,0,0,4,747,746,746,0,0,747,1,743,185.75,LKA,ROU,18776371,20668557,21336697,21919000,22442971,20246871,19815616,19265250,3.4080021898809254,3.8774477362089774
Norway,Thailand,812,732,805,709,664,712,745,-67,-0.08251231527093596,-7,-0.008695652173913044,81,0.12198795180722892,33,0.046348314606741575,NOR,THA,4490967,4889252,5188607,5379475,63066603,68270489,70294397,71475664,13.848935072660435,1.042312807335375
India,Curaçao,0,0,0,0,588,637,742,742,1,0,0,154,0.2619047619047619,105,0.16483516483516483,IND,CUW,1059633675,1240613620,1322866505,1396387127,133860,148703,157980,154947,0.053137126922253565,478.8734212343575
Laos,United Kingdom,64,254,450,522,550,658,741,677,10.578125,386,0.8577777777777778,191,0.3472727272727273,83,0.12613981762917933,LAO,GBR,5430853,6323418,6787419,7319399,58892514,62766365,65116219,67081234,10.123782020900897,1.104630842062327
Lebanon,Sri Lanka,8,94,181,358,723,732,741,733,91.625,173,0.9558011049723757,18,0.024896265560165973,9,0.012295081967213115,LBN,LKA,4320642,4995800,6398940,5662923,18776371,20668557,21336697,21919000,13.085115231127105,3.3806286783156163
Iran,Portugal,52,113,179,195,180,203,740,688,13.23076923076923,127,0.7094972067039106,560,3.111111111111111,537,2.645320197044335,IRN,PRT,65544383,75373855,81790841,87290193,10289898,10573100,10358076,10297081,0.8477470086473516,7.186502660317036
United States of America,Papua New Guinea,1110,1137,851,851,721,731,733,-377,-0.3396396396396396,-259,-0.30434782608695654,12,0.016643550624133148,2,0.0027359781121751026,USA,PNG,282162411,309327143,320738994,331526933,5508297,7583269,8682174,9749640,0.22109817545351584,7.518226313997235
Vietnam,Ireland,122,338,740,742,622,635,727,605,4.959016393442623,618,0.8351351351351352,105,0.16881028938906753,92,0.14488188976377953,VNM,IRL,79001142,87411012,92191398,96648685,3805174,4560155,4701957,4985382,0.7522088893397774,14.582633788143015
Pakistan,Russian Federation,1683,1367,1002,866,714,728,726,-957,-0.5686274509803921,-681,-0.6796407185628742,12,0.01680672268907563,-2,-0.0027472527472527475,PAK,RUS,154369924,194454498,210969298,227196741,146596869,142849468,144640716,145245148,0.3195468371617179,0.49984458000621135
Ireland,Hong Kong,466,520,574,627,681,695,724,258,0.5536480686695279,108,0.18815331010452963,43,0.0631424375917768,29,0.041726618705035974,IRL,HKG,3805174,4560155,4701957,4985382,6665000,7024200,7291300,7481000,14.522457857793045,9.67785055473867
Sweden,Thailand,249,416,670,634,645,692,724,475,1.9076305220883534,421,0.6283582089552239,79,0.12248062015503876,32,0.046242774566473986,SWE,THA,8872109,9378126,9799186,10353442,63066603,68270489,70294397,71475664,6.992843539375602,1.012932177866861
Pakistan,Lebanon,2361,2077,1793,1377,980,827,721,-1640,-0.6946209233375689,-568,-0.31678750697155605,-259,-0.2642857142857143,-106,-0.12817412333736397,PAK,LBN,154369924,194454498,210969298,227196741,4320642,4995800,6398940,5662923,0.31734610136859315,12.73194073096173
Bangladesh,Czechia,8,12,16,70,117,183,718,710,88.75,8,0.5,601,5.136752136752137,535,2.9234972677595628,BGD,CZE,129193327,148391139,157830000,167420951,10255063,10474410,10546059,10697858,0.4288591097538324,6.711623953131552
Philippines,Seychelles,61,229,398,514,630,705,718,657,10.770491803278688,337,0.8467336683417085,88,0.13968253968253969,13,0.018439716312056736,PHL,SYC,77958223,94636700,103031365,112190977,81131,89770,93419,98462,0.6399801652498311,729.2153318031321
Solomon Islands,Fiji,646,636,634,636,683,703,718,72,0.11145510835913312,-12,-0.01892744479495268,35,0.05124450951683748,15,0.021337126600284494,SLB,FJI,429978,540394,612660,691191,832509,905169,917200,920422,103.87866740162994,78.00769646966282
Cambodia,Sweden,254,302,324,379,468,557,717,463,1.8228346456692914,70,0.21604938271604937,249,0.532051282051282,160,0.2872531418312388,KHM,SWE,12118841,14363532,15417523,16396860,8872109,9378126,9799186,10353442,4.372788448520021,6.925233173663406
India,Turkey,126,304,485,501,517,511,713,587,4.658730158730159,359,0.7402061855670103,196,0.379110251450677,202,0.3953033268101761,IND,TUR,1059633675,1240613620,1322866505,1396387127,64113547,73142150,78218479,83384680,0.05106033894281239,0.8550731381352066
India,Estonia,25,39,53,82,111,318,712,687,27.48,28,0.5283018867924528,601,5.414414414414415,394,1.2389937106918238,IND,EST,1059633675,1240613620,1322866505,1396387127,1396985,1331475,1315407,1329522,0.05098872556421097,53.55308148342036
Indonesia,Finland,36,74,112,229,311,466,709,673,18.694444444444443,76,0.6785714285714286,398,1.279742765273312,243,0.5214592274678111,IDN,FIN,214072421,244016173,259091970,271857970,5176209,5363352,5479531,5529543,0.2607979453388841,12.822036106781338
South Korea,Finland,52,82,111,250,341,534,709,657,12.634615384615385,59,0.5315315315315315,368,1.0791788856304985,175,0.32771535580524347,KOR,FIN,47008111,49554112,51014947,51836239,5176209,5363352,5479531,5529543,1.3677689849373524,12.822036106781338
Vietnam,Bulgaria,346,381,416,494,566,557,709,363,1.0491329479768785,70,0.16826923076923078,143,0.25265017667844525,152,0.27289048473967686,VNM,BGR,79001142,87411012,92191398,96648685,8170172,7395599,7177991,6934015,0.733584735270842,10.224956248291935
Netherlands,Thailand,151,252,406,500,630,675,706,555,3.6754966887417218,255,0.6280788177339901,76,0.12063492063492064,31,0.045925925925925926,NLD,THA,15925513,16615394,16939923,17441500,63066603,68270489,70294397,71475664,4.047816988217757,0.9877487811795634
China,Guatemala,307,361,415,493,571,627,705,398,1.296416938110749,108,0.26024096385542167,134,0.23467600700525393,78,0.12440191387559808,CHN,GTM,1262645000,1337705000,1379860000,1411100000,11589761,14259687,15567419,16858333,0.04996102331514421,4.181908140027843
India,Namibia,997,953,886,700,674,659,704,-293,-0.2938816449348044,-111,-0.1252821670428894,30,0.04451038575667656,45,0.06828528072837632,IND,NAM,1059633675,1240613620,1322866505,1396387127,1819141,2099271,2282704,2489098,0.05041581853539961,28.283337980264335
South Korea,Turkey,124,299,477,493,508,503,700,576,4.645161290322581,353,0.740041928721174,192,0.3779527559055118,197,0.39165009940357853,KOR,TUR,47008111,49554112,51014947,51836239,64113547,73142150,78218479,83384680,1.3504066141835638,0.8394827443122646
Indonesia,Thailand,545,495,549,564,621,666,697,152,0.27889908256880735,4,0.007285974499089253,76,0.12238325281803543,31,0.046546546546546545,IDN,THA,214072421,244016173,259091970,271857970,63066603,68270489,70294397,71475664,0.25638387574217525,0.9751570828359146
Norway,Philippines,100,134,1176,951,642,653,693,593,5.93,1076,0.9149659863945578,51,0.0794392523364486,40,0.06125574272588055,NOR,PHL,4490967,4889252,5188607,5379475,77958223,94636700,103031365,112190977,12.882297993763332,0.6176967333121629
Pakistan,Iraq,525,619,587,683,698,682,688,163,0.31047619047619046,62,0.10562180579216354,-10,-0.014326647564469915,6,0.008797653958944282,PAK,IRQ,154369924,194454498,210969298,227196741,24628858,31264875,37757813,42556984,0.3028212451339696,1.616655917158039
Iran,Brazil,0,0,0,265,531,625,678,678,1,0,0,147,0.2768361581920904,53,0.0848,IRN,BRA,65544383,75373855,81790841,87290193,175873720,196353492,205188205,213196304,0.7767195565714925,0.3180167701218685
North Korea,Mongolia,51,56,62,271,512,633,678,627,12.294117647058824,11,0.1774193548387097,166,0.32421875,45,0.07109004739336493,PRK,MNG,23367059,24686435,25258015,25867467,2450979,2702520,2964749,3294335,2.6210529233496267,20.580784892853945
Malaysia,Italy,67,203,339,476,632,608,677,610,9.104477611940299,272,0.8023598820058997,45,0.071202531645569625,69,0.11348684210526316,MYS,ITA,22945150,28717731,31068833,33199993,56942108,59277417,60730582,59438851,2.0391570564487767,1.138985677902825
Nepal,Romania,0,0,0,0,0,11,677,677,1,0,0,677,1,666,60.54545454545455,NPL,ROU,24559500,27161567,27610325,29348627,22442971,20246871,19815616,19265250,2.306751862702129,3.514099220098364
China,Guyana,263,422,580,780,610,645,676,413,1.570342205323194,317,0.5465517241379311,66,0.10819672131147541,31,0.04806201550387597,CHN,GUY,1262645000,1337705000,1379860000,1411100000,759051,747932,755031,797202,0.047905889022748206,84.7965760246462
Bangladesh,Sri Lanka,7,85,164,326,658,665,673,666,95.14285714285714,157,0.9573170731707317,15,0.022796352583586626,8,0.012030075187969926,BGD,LKA,129193327,148391139,157830000,167420951,18776371,20668557,21336697,21919000,0.40198075329293764,3.0703955472421187
India,Belize,247,256,265,292,502,592,670,423,1.7125506072874495,18,0.06792452830188679,168,0.3346613545816733,78,0.13175675675675674,IND,BLZ,1059633675,1240613620,1322866505,1396387127,240406,322106,359871,394921,0.04798096366295133,169.65418400135724
Iraq,India,1189,900,610,700,770,717,670,-519,-0.43650126156433977,-579,-0.9491803278688524,-100,-0.12987012987012986,-47,-0.06555090655509066,IRQ,IND,24628858,31264875,37757813,42556984,1059633675,1240613620,1322866505,1396387127,1.5743596867672767,0.04798096366295133
Italy,Hong Kong,430,480,530,579,629,642,669,239,0.5558139534883721,100,0.18867924528301888,40,0.06359300476947535,27,0.04205607476635514,ITA,HKG,56942108,59277417,60730582,59438851,6665000,7024200,7291300,7481000,1.1255264675287884,8.942654725304104
Australia,Vanuatu,442,445,450,549,612,651,665,223,0.504524886877828,8,0.017777777777777778,53,0.08660130718954248,14,0.021505376344086023,AUS,VUT,19028802,22031750,23815995,25649248,192074,245453,276438,311685,2.5926686037734905,213.35643357877345
Denmark,Thailand,429,392,437,497,593,636,665,236,0.5501165501165501,8,0.018306636155606407,72,0.12141652613827993,29,0.04559748427672956,DNK,THA,5339616,5547683,5683483,5831404,63066603,68270489,70294397,71475664,11.403771716039568,0.9303865998362744
Pakistan,Czechia,23,34,45,222,376,533,662,639,27.782608695652176,22,0.4888888888888889,286,0.7606382978723404,129,0.24202626641651032,PAK,CZE,154369924,194454498,210969298,227196741,10255063,10474410,10546059,10697858,0.29137741900972075,6.188154675449983
Maldives,Australia,80,113,170,280,430,610,656,576,7.2,90,0.5294117647058824,226,0.5255813953488372,46,0.07540983606557378,MDV,AUS,282507,361575,435582,514438,19028802,22031750,23815995,25649248,127.51779611926024,2.557579855752496
Israel,Philippines,59,79,555,449,605,614,652,593,10.05084745762712,496,0.8936936936936937,47,0.07768595041322314,38,0.06188925081433225,ISR,PHL,6289000,7623600,8380100,9215100,77958223,94636700,103031365,112190977,7.075343729313843,0.5811519049343871
India,Cayman Islands,44,84,144,324,535,582,648,604,13.727272727272727,100,0.6944444444444444,113,0.21121495327102804,66,0.1134020618556701,IND,CYM,1059633675,1240613620,1322866505,1396387127,39658,54074,60911,67311,0.04640546933372009,962.6955475330927
Thailand,Luxembourg,168,159,153,132,114,173,644,476,2.8333333333333335,-15,-0.09803921568627451,530,4.649122807017544,471,2.722543352601156,THA,LUX,63066603,68270489,70294397,71475664,436300,506953,569604,630419,0.9010059703677604,102.15428151753041
Sweden,Philippines,99,133,121,97,596,605,643,544,5.494949494949495,22,0.18181818181818182,47,0.07885906040268456,38,0.0628099173553719,SWE,PHL,8872109,9378126,9799186,10353442,77958223,94636700,103031365,112190977,6.210495021848773,0.5731298694368264
India,Bahamas,160,194,229,391,552,598,640,480,3,69,0.30131004366812225,88,0.15942028985507245,42,0.07023411371237458,IND,BHS,1059633675,1240613620,1322866505,1396387127,325014,373272,392697,406471,0.04583256230490873,157.45280721133858
Italy,Thailand,662,598,658,591,567,608,636,-26,-0.03927492447129909,-4,-0.0060790273556231,69,0.12169312169312169,28,0.046052631578947366,ITA,THA,56942108,59277417,60730582,59438851,63066603,68270489,70294397,71475664,1.0700072247358887,0.8898133496178503
Bhutan,Denmark,7,8,9,148,271,642,632,625,89.28571428571429,2,0.2222222222222222,361,1.3321033210332103,-10,-0.01557632398753894,BTN,DNK,587207,705516,743274,772506,5339616,5547683,5683483,5831404,81.811662304241,10.837870262461665
India,Liberia,774,756,742,546,712,817,631,-143,-0.1847545219638243,-32,-0.0431266846361186,-81,-0.11376404494382023,-186,-0.22766217870257038,IND,LBR,1059633675,1240613620,1322866505,1396387127,2895224,4019956,4612329,5087584,0.04518804189749595,12.402743620547593
Laos,New Caledonia,515,597,679,723,768,590,625,110,0.21359223300970873,164,0.24153166421207659,-143,-0.18619791666666666,35,0.059322033898305086,LAO,NCL,5430853,6323418,6787419,7319399,213230,249750,269460,271080,8.53895244677876,230.55924450346762
Pakistan,Romania,1,1,1,1,11,289,625,624,624,0,0,614,55.81818181818182,336,1.1626297577854672,PAK,ROU,154369924,194454498,210969298,227196741,22442971,20246871,19815616,19265250,0.2750919741405974,3.2441831795590503
Myanmar,Russian Federation,411,339,256,440,615,626,624,213,0.5182481751824818,-155,-0.60546875,9,0.014634146341463415,-2,-0.003194888178913738,MMR,RUS,45538332,49390988,51483949,53423198,146596869,142849468,144640716,145245148,1.1680319100327914,0.4296184819888097
Iran,Philippines,212,285,975,789,577,586,622,410,1.9339622641509433,763,0.7825641025641026,45,0.0779896013864818,36,0.06143344709897611,IRN,PHL,65544383,75373855,81790841,87290193,77958223,94636700,103031365,112190977,0.7125657288900713,0.5544117866091851
Pakistan,Vietnam,30,70,166,338,490,591,622,592,19.733333333333334,136,0.8192771084337349,132,0.2693877551020408,31,0.05245346869712352,PAK,VNM,154369924,194454498,210969298,227196741,79001142,87411012,92191398,96648685,0.2737715326647225,0.6435679906043212
New Zealand,Fiji,1211,1045,870,548,588,606,619,-592,-0.4888521882741536,-341,-0.39195402298850573,31,0.05272108843537415,13,0.02145214521452145,NZL,FJI,3857700,4350700,4609400,5090200,832509,905169,917200,920422,12.160622372401871,67.25176060546141
Pakistan,Egypt,387,403,452,538,580,398,619,232,0.599483204134367,65,0.14380530973451328,39,0.06724137931034482,221,0.5552763819095478,PAK,EGY,154369924,194454498,210969298,227196741,71371371,87252413,97723799,107465134,0.27245109118884764,0.576000770631338
India,Tajikistan,935,760,654,630,628,617,618,-317,-0.3390374331550802,-281,-0.42966360856269115,-10,-0.01592356687898089,1,0.0016207455429497568,IND,TJK,1059633675,1240613620,1322866505,1396387127,6272998,7621779,8524063,9543207,0.044257067975677494,6.475810490121402
Vietnam,New Caledonia,499,578,658,706,753,583,617,118,0.23647294589178355,159,0.24164133738601823,-136,-0.1806108897742364,34,0.058319039451114926,VNM,NCL,79001142,87411012,92191398,96648685,213230,249750,269460,271080,0.6383946144740614,227.6080861738232
Afghanistan,Spain,24,37,455,219,439,458,615,591,24.625,431,0.9472527472527472,176,0.4009111617312073,157,0.34279475982532753,AFG,ESP,19542982,28189672,33753499,38972230,40567864,46576897,46444832,47365655,1.5780467271182583,1.2984091532144968
China,French Polynesia,546,599,641,671,648,615,615,69,0.12637362637362637,95,0.1482059282371295,-33,-0.05092592592592592,0,0,CHN,PYF,1262645000,1337705000,1379860000,1411100000,250927,283788,291787,301920,0.043583020338742826,203.69634340222575
United States of America,Sri Lanka,18,87,158,302,598,605,613,595,33.05555555555556,140,0.8860759493670886,15,0.02508361204013378,8,0.013223140495867768,USA,LKA,282162411,309327143,320738994,331526933,18776371,20668557,21336697,21919000,0.18490202121828817,2.7966604315890327
Singapore,Sri Lanka,8,78,150,296,597,604,612,604,75.5,142,0.9466666666666667,15,0.02512562814070352,8,0.013245033112582781,SGP,LKA,4027887,5076732,5535002,5685807,18776371,20668557,21336697,21919000,10.76364357777181,2.792098179661481
Thailand,Ireland,103,285,624,626,524,535,612,509,4.941747572815534,521,0.8349358974358975,88,0.16793893129770993,77,0.14392523364485982,THA,IRL,63066603,68270489,70294397,71475664,3805174,4560155,4701957,4985382,0.8562354873681202,12.27588979139412
South Korea,Sri Lanka,7,77,149,296,596,603,611,604,86.28571428571429,142,0.9530201342281879,15,0.025167785234899327,8,0.013266998341625208,KOR,LKA,47008111,49554112,51014947,51836239,18776371,20668557,21336697,21919000,1.1787120589516535,2.7875359277339293
Philippines,Peru,200,201,235,276,308,328,610,410,2.05,35,0.14893617021276595,302,0.9805194805194806,282,0.8597560975609756,PHL,PER,77958223,94636700,103031365,112190977,26654439,29229572,30711863,33304756,0.5437157392791044,1.8315702417996997
South Korea,Slovakia,0,152,346,388,435,534,609,609,1,346,1,174,0.4,75,0.1404494382022472,KOR,SVK,47008111,49554112,51014947,51836239,5388720,5391428,5423801,5458827,1.1748537543397004,11.156242907130048
Sri Lanka,Seychelles,316,391,467,500,534,598,609,293,0.9272151898734177,151,0.3233404710920771,75,0.1404494382022472,11,0.01839464882943144,LKA,SYC,18776371,20668557,21336697,21919000,81131,89770,93419,98462,2.7784114238788264,618.5127257215981
China,Honduras,394,419,443,434,425,596,608,214,0.5431472081218274,49,0.11060948081264109,183,0.43058823529411766,12,0.020134228187919462,CHN,HND,1262645000,1337705000,1379860000,1411100000,6656725,8450933,9294505,10121763,0.04308695344057827,6.0068586865746605
Tunisia,Philippines,17,22,242,195,560,568,603,586,34.470588235294116,225,0.9297520661157025,43,0.07678571428571429,35,0.061619718309859156,TUN,PHL,9893316,10895063,11557779,12161723,77958223,94636700,103031365,112190977,4.958179034335842,0.5374763783365573
China,American Samoa,100,200,299,450,600,598,599,499,4.99,199,0.6655518394648829,-1,-0.0016666666666666668,1,0.0016722408026755853,CHN,ASM,1262645000,1337705000,1379860000,1411100000,58230,54849,51368,46189,0.04244915314293814,1296.8455692913897
Pakistan,United Republic of Tanzania,407,517,545,617,635,668,595,188,0.4619164619164619,138,0.25321100917431194,-40,-0.06299212598425197,-73,-0.1092814371257485,PAK,TZA,154369924,194454498,210969298,227196741,34463704,45110527,52542823,61704518,0.2618875593818487,0.9642729888919966
Malaysia,Austria,266,300,334,370,410,484,588,322,1.2105263157894737,68,0.20359281437125748,178,0.43414634146341463,104,0.21487603305785125,MYS,AUT,22945150,28717731,31068833,33199993,8011566,8363404,8642699,8916864,1.771084710770873,6.594246587140949
Hong Kong,France,2227,2299,2371,1415,484,535,587,-1640,-0.7364167040862146,144,0.060733867566427666,103,0.2128099173553719,52,0.09719626168224299,HKG,FRA,6665000,7024200,7291300,7481000,60921384,65030575,66548272,67571107,7.846544579601657,0.8687144936074527
South Korea,Dominican Republic,548,609,669,604,538,564,587,39,0.07116788321167883,121,0.18086696562032886,49,0.09107806691449814,23,0.040780141843971635,KOR,DOM,47008111,49554112,51014947,51836239,8540791,9775755,10405832,10999664,1.132412403608217,5.336526642995641
Sri Lanka,Russian Federation,1020,941,829,709,576,588,586,-434,-0.42549019607843136,-191,-0.23039806996381182,10,0.017361111111111112,-2,-0.003401360544217687,LKA,RUS,18776371,20668557,21336697,21919000,146596869,142849468,144640716,145245148,2.6734796295451435,0.40345581802154246
Cambodia,New Caledonia,482,558,635,676,718,551,584,102,0.21161825726141079,153,0.2409448818897638,-134,-0.18662952646239556,33,0.05989110707803993,KHM,NCL,12118841,14363532,15417523,16396860,213230,249750,269460,271080,3.561657536869864,215.43455806404015
Thailand,Brazil,0,0,0,0,457,538,583,583,1,0,0,126,0.27571115973741794,45,0.08364312267657993,THA,BRA,63066603,68270489,70294397,71475664,175873720,196353492,205188205,213196304,0.8156622371496961,0.2734568982021377
China,Israel,1027,1002,921,747,582,600,581,-446,-0.4342745861733204,-106,-0.11509229098805646,-1,-0.001718213058419244,-19,-0.03166666666666667,CHN,ISR,1262645000,1337705000,1379860000,1411100000,6289000,7623600,8380100,9215100,0.04117355254765786,6.304869182103287
Thailand,North Korea,232,300,368,440,511,563,574,342,1.4741379310344827,136,0.3695652173913043,63,0.1232876712328767,11,0.019538188277087035,THA,PRK,63066603,68270489,70294397,71475664,23367059,24686435,25258015,25867467,0.8030705388060474,2.2190035073785928
India,Bermuda,156,220,242,336,445,493,572,416,2.6666666666666665,86,0.35537190082644626,127,0.2853932584269663,79,0.16024340770791076,IND,BMU,1059633675,1240613620,1322866505,1396387127,61833,65124,65237,63893,0.040962852560012177,895.2467406445151
Philippines,Mexico,186,315,458,453,500,522,572,386,2.075268817204301,272,0.5938864628820961,72,0.144,50,0.09578544061302682,PHL,MEX,77958223,94636700,103031365,112190977,97873442,112532401,120149897,125998302,0.5098449227338487,0.45397437181335987
Vietnam,Luxembourg,70,66,63,54,47,71,570,500,7.142857142857143,-7,-0.1111111111111111,523,11.127659574468085,499,7.028169014084507,VNM,LUX,79001142,87411012,92191398,96648685,436300,506953,569604,630419,0.5897648788496191,90.4160566226589
China,Curaçao,0,0,0,0,451,489,569,569,1,0,0,118,0.2616407982261641,80,0.16359918200409,CHN,CUW,1262645000,1337705000,1379860000,1411100000,133860,148703,157980,154947,0.040323152150804335,367.2223405422499
India,Lithuania,0,0,0,0,0,11,567,567,1,0,0,567,1,556,50.54545454545455,IND,LTU,1059633675,1240613620,1322866505,1396387127,3499536,3097282,2904910,2794885,0.04060478566700508,20.28706011159672
Indonesia,Hungary,191,169,147,181,217,211,567,376,1.968586387434555,-44,-0.29931972789115646,350,1.6129032258064515,356,1.6872037914691944,IDN,HUN,214072421,244016173,259091970,271857970,10210971,10000023,9843028,9750149,0.2085647884444955,5.815295745736809
Belgium,Philippines,76,102,848,686,524,533,566,490,6.447368421052632,772,0.910377358490566,42,0.08015267175572519,33,0.06191369606003752,BEL,PHL,10251250,10895586,11274196,11538604,77958223,94636700,103031365,112190977,4.9052727695655385,0.5044968990688083
Mongolia,Spain,10,16,193,93,367,419,565,555,55.5,183,0.9481865284974094,198,0.5395095367847411,146,0.34844868735083534,MNG,ESP,2450979,2702520,2964749,3294335,40567864,46576897,46444832,47365655,17.150654077378288,1.1928474334409604
Congo,Philippines,121,162,555,449,521,529,561,440,3.6363636363636362,434,0.781981981981982,40,0.07677543186180422,32,0.06049149338374291,COG,PHL,3134030,4437884,5064386,5702174,77958223,94636700,103031365,112190977,9.838352880848602,0.5000402126812747
South Korea,Bolivia (Plurinational State of),555,564,568,502,434,506,561,6,0.010810810810810811,13,0.022887323943661973,127,0.2926267281105991,55,0.10869565217391304,KOR,BOL,47008111,49554112,51014947,51836239,8592656,10223270,11090085,11936162,1.0822544436528276,4.7000032338703175
Germany,Sri Lanka,21,83,147,278,547,554,560,539,25.666666666666668,126,0.8571428571428571,13,0.02376599634369287,6,0.010830324909747292,DEU,LKA,82211508,81776930,81686611,83160871,18776371,20668557,21336697,21919000,0.6733936204203538,2.554861079428806
Hong Kong,Brunei Darussalam,382,432,482,493,504,515,559,177,0.46335078534031415,100,0.2074688796680498,55,0.10912698412698413,44,0.0854368932038835,HKG,BRN,6665000,7024200,7291300,7481000,333926,396053,421437,441725,7.4722630664349685,126.5493236742317
France,Vanuatu,244,242,240,379,510,543,555,311,1.2745901639344261,-4,-0.016666666666666666,45,0.08823529411764706,12,0.022099447513812154,FRA,VUT,60921384,65030575,66548272,67571107,192074,245453,276438,311685,0.8213569743647977,178.0643919341643
Afghanistan,Mali,0,0,0,0,385,473,553,553,1,0,0,168,0.43636363636363634,80,0.16913319238900634,AFG,MLI,19542982,28189672,33753499,38972230,11239101,15529181,18112907,21224040,1.4189590895876372,2.6055359865510996
Australia,Timor-Leste,425,451,482,522,543,562,553,128,0.30117647058823527,57,0.11825726141078838,10,0.01841620626151013,-9,-0.01601423487544484,AUS,TLS,19028802,22031750,23815995,25649248,878360,1088486,1205813,1299995,2.1560086284011133,42.53862514855826
India,Bulgaria,163,149,135,137,138,251,553,390,2.392638036809816,-28,-0.2074074074074074,415,3.0072463768115942,302,1.203187250996016,IND,BGR,1059633675,1240613620,1322866505,1396387127,8170172,7395599,7177991,6934015,0.0396021983665852,7.97517744048722
Portugal,Thailand,53,88,143,306,491,526,550,497,9.377358490566039,90,0.6293706293706294,59,0.12016293279022404,24,0.045627376425855515,PRT,THA,10289898,10573100,10358076,10297081,63066603,68270489,70294397,71475664,5.341319544830229,0.7694926765563171
Pakistan,Malta,54,64,81,97,149,253,549,495,9.166666666666666,27,0.3333333333333333,400,2.684563758389262,296,1.1699604743083003,PAK,MLT,154369924,194454498,210969298,227196741,390087,414508,445053,515332,0.24164079008510073,106.53326399292108
Papua New Guinea,Solomon Islands,1110,1098,1047,800,603,564,549,-561,-0.5054054054054054,-63,-0.06017191977077364,-54,-0.08955223880597014,-15,-0.026595744680851064,PNG,SLB,5508297,7583269,8682174,9749640,429978,540394,612660,691191,5.630977143771463,79.42811755361397
Mongolia,Netherlands,27,39,54,410,449,475,546,519,19.22222222222222,27,0.5,97,0.21603563474387527,71,0.14947368421052631,MNG,NLD,2450979,2702520,2964749,3294335,15925513,16615394,16939923,17441500,16.573906418139018,3.1304646962703893
India,Romania,0,0,0,0,9,78,544,544,1,0,0,535,59.44444444444444,466,5.9743589743589745,IND,ROU,1059633675,1240613620,1322866505,1396387127,22442971,20246871,19815616,19265250,0.038957677959172425,2.8237370394881975
Philippines,Portugal,74,160,253,366,419,474,542,468,6.324324324324325,179,0.7075098814229249,123,0.2935560859188544,68,0.14345991561181434,PHL,PRT,77958223,94636700,103031365,112190977,10289898,10573100,10358076,10297081,0.4831048044086469,5.263627624178152
Philippines,Marshall Islands,120,209,311,398,509,541,541,421,3.5083333333333333,191,0.6141479099678456,32,0.06286836935166994,0,0,PHL,MHL,77958223,94636700,103031365,112190977,54224,53416,49410,43413,0.48221346713114016,1246.170501923387
Bangladesh,Bulgaria,22,150,278,429,571,478,539,517,23.5,256,0.920863309352518,-32,-0.05604203152364273,61,0.12761506276150628,BGD,BGR,129193327,148391139,157830000,167420951,8170172,7395599,7177991,6934015,0.3219429807204954,7.773274214145772
Hong Kong,Venezuela (Bolivarian Republic of),507,500,490,515,547,573,539,32,0.0631163708086785,-17,-0.03469387755102041,-8,-0.014625228519195612,-34,-0.059336823734729496,HKG,VEN,6665000,7024200,7291300,7481000,24427729,28715022,30529716,28490453,7.204919128458761,1.8918618106914622
Sri Lanka,Pakistan,889,413,569,384,663,578,539,-350,-0.3937007874015748,-320,-0.562390158172232,-124,-0.1870286576168929,-39,-0.06747404844290658,LKA,PAK,18776371,20668557,21336697,21919000,154369924,194454498,210969298,227196741,2.4590537889502255,0.2372393184988512
Myanmar,France,673,695,716,369,442,490,537,-136,-0.20208023774145617,43,0.06005586592178771,95,0.2149321266968326,47,0.09591836734693877,MMR,FRA,45538332,49390988,51483949,53423198,60921384,65030575,66548272,67571107,1.005181307191681,0.7947183697908042
Austria,Philippines,92,123,1657,1341,495,503,533,441,4.793478260869565,1565,0.9444779722389861,38,0.07676767676767676,30,0.05964214711729622,AUT,PHL,8011566,8363404,8642699,8916864,77958223,94636700,103031365,112190977,5.977437807731508,0.47508276891108636
Peru,North Korea,87,207,327,401,474,522,533,446,5.126436781609195,240,0.7339449541284404,59,0.12447257383966245,11,0.0210727969348659,PER,PRK,26654439,29229572,30711863,33304756,23367059,24686435,25258015,25867467,1.6003720309495737,2.06050325685155
Philippines,Hungary,0,85,170,209,250,282,533,533,1,170,1,283,1.132,251,0.8900709219858156,PHL,HUN,77958223,94636700,103031365,112190977,10210971,10000023,9843028,9750149,0.47508276891108636,5.4665831260629965
Fiji,Kiribati,221,248,275,382,489,497,531,310,1.4027149321266967,54,0.19636363636363635,42,0.08588957055214724,34,0.06841046277665996,FJI,KIR,832509,905169,917200,920422,88826,107995,116707,126463,57.69092872617126,419.88565825577444
Malaysia,Finland,142,165,188,287,362,411,531,389,2.73943661971831,46,0.24468085106382978,169,0.46685082872928174,120,0.291970802919708,MYS,FIN,22945150,28717731,31068833,33199993,5176209,5363352,5479531,5529543,1.5993979275839005,9.602963572215643
Pakistan,Philippines,262,352,1232,997,491,499,530,268,1.0229007633587786,970,0.7873376623376623,39,0.07942973523421588,31,0.06212424849699399,PAK,PHL,154369924,194454498,210969298,227196741,77958223,94636700,103031365,112190977,0.23327799407122657,0.4724087570785661
Thailand,Mali,0,0,0,0,364,447,523,523,1,0,0,159,0.4368131868131868,76,0.17002237136465326,THA,MLI,63066603,68270489,70294397,71475664,11239101,15529181,18112907,21224040,0.7317175815253707,2.4641868371902804
China,Togo,247,278,313,352,459,517,521,274,1.1093117408906883,66,0.2108626198083067,62,0.13507625272331156,4,0.007736943907156673,CHN,TGO,1262645000,1337705000,1379860000,1411100000,5008035,6571855,7473229,8442580,0.03692155056339026,6.171099355884102
China,Seychelles,58,80,103,279,456,510,519,461,7.948275862068965,45,0.4368932038834951,63,0.13815789473684212,9,0.01764705882352941,CHN,SYC,1262645000,1337705000,1379860000,1411100000,81131,89770,93419,98462,0.03677981716391467,527.1069041863866
Netherlands,Philippines,82,110,229,185,476,483,513,431,5.2560975609756095,147,0.6419213973799127,37,0.07773109243697479,30,0.062111801242236024,NLD,PHL,15925513,16615394,16939923,17441500,77958223,94636700,103031365,112190977,2.941260786056245,0.4572560233609517
Laos,Sweden,284,337,362,412,465,479,509,225,0.7922535211267606,78,0.2154696132596685,44,0.09462365591397849,30,0.06263048016701461,LAO,SWE,5430853,6323418,6787419,7319399,8872109,9378126,9799186,10353442,6.9541228726566215,4.916239449643896
Iran,Ireland,85,237,519,520,436,445,508,423,4.976470588235294,434,0.8362235067437379,72,0.1651376146788991,63,0.14157303370786517,IRN,IRL,65544383,75373855,81790841,87290193,3805174,4560155,4701957,4985382,0.5819668653957495,10.18979087259512
North Korea,Ecuador,162,182,202,242,384,485,507,345,2.1296296296296298,40,0.19801980198019803,123,0.3203125,22,0.04536082474226804,PRK,ECU,23367059,24686435,25258015,25867467,12626507,14989585,16195902,17588595,1.9599909028587919,2.8825497431716407
China,Estonia,59,92,124,163,201,348,495,436,7.389830508474576,65,0.5241935483870968,294,1.462686567164179,147,0.4224137931034483,CHN,EST,1262645000,1337705000,1379860000,1411100000,1396985,1331475,1315407,1329522,0.03507901637020764,37.2314260313105
Algeria,Philippines,795,1069,541,437,454,462,490,-305,-0.3836477987421384,-254,-0.46950092421441775,36,0.07929515418502203,28,0.06060606060606061,DZA,PHL,30774621,35856344,39543154,43451666,77958223,94636700,103031365,112190977,1.1276897875446248,0.436755265978297
Ecuador,Philippines,105,141,481,389,452,459,487,382,3.638095238095238,376,0.7817047817047817,35,0.07743362831858407,28,0.061002178649237473,ECU,PHL,12626507,14989585,16195902,17588595,77958223,94636700,103031365,112190977,2.768839694131339,0.43408125414577686
China,Palau,320,543,1079,550,526,473,486,166,0.51875,759,0.7034291010194624,-40,-0.07604562737642585,13,0.02748414376321353,CHN,PLW,1262645000,1337705000,1379860000,1411100000,19726,18540,17794,17972,0.0344412160725675,2704.20654351213
Afghanistan,Czechia,51,77,103,221,317,418,484,433,8.490196078431373,52,0.5048543689320388,167,0.526813880126183,66,0.15789473684210525,AFG,CZE,19542982,28189672,33753499,38972230,10255063,10474410,10546059,10697858,1.2419099445938813,4.524270185676422
South Korea,Panama,96,139,191,243,345,402,483,387,4.03125,95,0.4973821989528796,138,0.4,81,0.20149253731343283,KOR,PAN,47008111,49554112,51014947,51836239,3001731,3623617,3957099,4294396,0.931780563786659,11.247216139359296
Iran,Bulgaria,98,127,155,199,239,303,475,377,3.8469387755102042,57,0.36774193548387096,236,0.9874476987447699,172,0.5676567656765676,IRN,BGR,65544383,75373855,81790841,87290193,8170172,7395599,7177991,6934015,0.5441619312263406,6.850288036584865
Australia,Sri Lanka,51,100,150,253,465,469,474,423,8.294117647058824,99,0.66,9,0.01935483870967742,5,0.010660980810234541,AUS,LKA,19028802,22031750,23815995,25649248,18776371,20668557,21336697,21919000,1.8480073957723828,2.1625074136593825
Cambodia,Norway,107,155,173,222,328,405,472,365,3.411214953271028,66,0.3815028901734104,144,0.43902439024390244,67,0.1654320987654321,KHM,NOR,12118841,14363532,15417523,16396860,4490967,4889252,5188607,5379475,2.8785999270592053,8.77409040845064
Fiji,Tonga,369,417,466,544,582,499,470,101,0.27371273712737126,97,0.20815450643776823,-112,-0.19243986254295534,-29,-0.05811623246492986,FJI,TON,832509,905169,917200,920422,102603,107383,106122,105254,51.063533900754216,446.5388488798526
Bangladesh,Russian Federation,1280,1035,753,614,463,471,469,-811,-0.63359375,-527,-0.699867197875166,6,0.012958963282937365,-2,-0.004246284501061571,BGD,RUS,129193327,148391139,157830000,167420951,146596869,142849468,144640716,145245148,0.28013220400354794,0.32290235264864064
Denmark,Philippines,182,244,846,684,436,442,468,286,1.5714285714285714,664,0.7848699763593381,32,0.07339449541284404,26,0.058823529411764705,DNK,PHL,5339616,5547683,5683483,5831404,77958223,94636700,103031365,112190977,8.025511523468447,0.41714584587314896
India,Barbados,441,481,522,480,441,463,467,26,0.05895691609977324,81,0.15517241379310345,26,0.05895691609977324,4,0.008639308855291577,IND,BRB,1059633675,1240613620,1322866505,1396387127,264657,274711,278083,280693,0.03344344780686309,166.37393878721593
Pakistan,Botswana,145,175,223,374,402,436,464,319,2.2,78,0.34977578475336324,62,0.15422885572139303,28,0.06422018348623854,PAK,BWA,154369924,194454498,210969298,227196741,1726985,2091664,2305171,2546402,0.2042282816019795,18.221789018387515
Bangladesh,Hong Kong,297,332,366,400,435,444,462,165,0.5555555555555556,69,0.1885245901639344,27,0.06206896551724138,18,0.04054054054054054,BGD,HKG,129193327,148391139,157830000,167420951,6665000,7024200,7291300,7481000,0.27595112633185315,6.175644967250367
Ireland,Philippines,33,44,212,171,425,431,457,424,12.848484848484848,179,0.8443396226415094,32,0.07529411764705882,26,0.060324825986078884,IRL,PHL,3805174,4560155,4701957,4985382,77958223,94636700,103031365,112190977,9.16680005664561,0.4073411358205749
Philippines,Andorra,146,222,297,392,443,425,457,311,2.1301369863013697,151,0.5084175084175084,14,0.03160270880361174,32,0.07529411764705882,PHL,AND,77958223,94636700,103031365,112190977,66097,71519,71746,77700,0.4073411358205749,588.1595881595881
United Arab Emirates,Philippines,99,133,453,366,425,431,457,358,3.6161616161616164,354,0.7814569536423841,32,0.07529411764705882,26,0.060324825986078884,ARE,PHL,3275333,8481771,8916899,9287289,77958223,94636700,103031365,112190977,4.9207039858456,0.4073411358205749
Philippines,Brazil,0,0,0,0,355,418,452,452,1,0,0,97,0.27323943661971833,34,0.08133971291866028,PHL,BRA,77958223,94636700,103031365,112190977,175873720,196353492,205188205,213196304,0.4028844494330413,0.2120111800812457
Bangladesh,Turkey,79,192,307,318,327,323,450,371,4.69620253164557,228,0.742671009771987,123,0.3761467889908257,127,0.3931888544891641,BGD,TUR,129193327,148391139,157830000,167420951,64113547,73142150,78218479,83384680,0.2687835646089479,0.5396674784864558
Indonesia,Greece,195,225,259,356,470,442,450,255,1.3076923076923077,64,0.2471042471042471,-20,-0.0425531914893617,8,0.01809954751131222,IDN,GRC,214072421,244016173,259091970,271857970,10805808,11121341,10820883,10698599,0.16552760987658371,4.2061582081915585
Myanmar,Philippines,55,74,333,269,415,421,447,392,7.127272727272727,278,0.8348348348348348,32,0.07710843373493977,26,0.06175771971496437,MMR,PHL,45538332,49390988,51483949,53423198,77958223,94636700,103031365,112190977,0.8367151663215668,0.39842776304550764
Japan,Mongolia,122,134,149,229,336,415,444,322,2.639344262295082,27,0.18120805369127516,108,0.32142857142857145,29,0.06987951807228916,JPN,MNG,126843000,128070000,127141000,126261000,2450979,2702520,2964749,3294335,0.3516525292845772,13.477682142222935
Iran,Libya,383,340,303,334,367,410,439,56,0.1462140992167102,-80,-0.264026402640264,72,0.19618528610354224,29,0.07073170731707316,IRN,LBY,65544383,75373855,81790841,87290193,5154790,6491988,6192235,6653942,0.5029201848597127,6.59759282542589
Vietnam,Philippines,18174,24458,601,486,406,413,438,-17736,-0.9758996368438428,-17573,-29.239600665557404,32,0.07881773399014778,25,0.06053268765133172,VNM,PHL,79001142,87411012,92191398,96648685,77958223,94636700,103031365,112190977,0.45318774901076,0.3904057275479471
Myanmar,Italy,28,97,165,303,385,451,437,409,14.607142857142858,137,0.8303030303030303,52,0.13506493506493505,-14,-0.031042128603104215,MMR,ITA,45538332,49390988,51483949,53423198,56942108,59277417,60730582,59438851,0.8179967062248876,0.7352093666817348
Afghanistan,Luxembourg,0,0,0,0,0,0,433,433,1,0,0,433,1,433,1,AFG,LUX,19542982,28189672,33753499,38972230,436300,506953,569604,630419,1.1110475330767575,68.68447810107247
Kazakhstan,India,1408,2052,2696,1449,497,463,433,-975,-0.6924715909090909,1288,0.47774480712166173,-64,-0.12877263581488935,-30,-0.06479481641468683,KAZ,IND,14883626,16321872,17542806,18755666,1059633675,1240613620,1322866505,1396387127,2.3086356944082924,0.03100859293441481
Oman,Philippines,93,125,428,346,401,408,433,340,3.6559139784946235,335,0.7827102803738317,32,0.0798004987531172,25,0.061274509803921566,OMN,PHL,2344253,2881914,4191776,4543399,77958223,94636700,103031365,112190977,9.530309796696262,0.38594904116041345
Afghanistan,Bulgaria,222,223,223,2320,2450,3438,426,204,0.918918918918919,1,0.004484304932735426,-2024,-0.8261224489795919,-3012,-0.8760907504363001,AFG,BGR,19542982,28189672,33753499,38972230,8170172,7395599,7177991,6934015,1.0930860256136228,6.1436267443897945
Solomon Islands,United Kingdom,42,170,302,301,317,379,425,383,9.119047619047619,260,0.8609271523178808,108,0.34069400630914826,46,0.12137203166226913,SLB,GBR,429978,540394,612660,691191,58892514,62766365,65116219,67081234,61.488069144418844,0.6335601995634129
Mongolia,Poland,234,200,171,248,334,318,424,190,0.811965811965812,-63,-0.3684210526315789,90,0.2694610778443114,106,0.3333333333333333,MNG,POL,2450979,2702520,2964749,3294335,38258629,38042794,37986412,37899070,12.870579343023705,1.11876096168059
Tuvalu,Fiji,378,372,371,372,399,411,420,42,0.1111111111111111,-7,-0.018867924528301886,21,0.05263157894736842,9,0.021897810218978103,TUV,FJI,9638,10550,10877,11069,832509,905169,917200,920422,3794.380702863854,45.63124306024845
India,Lesotho,308,266,215,219,223,318,419,111,0.36038961038961037,-93,-0.4325581395348837,196,0.8789237668161435,101,0.31761006289308175,IND,LSO,1059633675,1240613620,1322866505,1396387127,1998630,2022747,2118521,2254100,0.030006005633994935,18.588350117563554
Pakistan,Lesotho,308,266,215,219,223,318,419,111,0.36038961038961037,-93,-0.4325581395348837,196,0.8789237668161435,101,0.31761006289308175,PAK,LSO,154369924,194454498,210969298,227196741,1998630,2022747,2118521,2254100,0.1844216594638565,18.588350117563554
Spain,Hong Kong,269,300,331,362,393,401,418,149,0.5539033457249071,62,0.18731117824773413,25,0.06361323155216285,17,0.04239401496259352,ESP,HKG,40567864,46576897,46444832,47365655,6665000,7024200,7291300,7481000,0.8824959773067638,5.587488303702713
China,Croatia,0,0,0,222,443,446,417,417,1,0,0,-26,-0.05869074492099323,-29,-0.06502242152466367,CHN,HRV,1262645000,1337705000,1379860000,1411100000,4468302,4295427,4203604,4047680,0.02955141379065977,10.302197802197803
New Zealand,Philippines,117,157,105,84,378,383,407,290,2.4786324786324787,-12,-0.11428571428571428,29,0.07671957671957672,24,0.06266318537859007,NZL,PHL,3857700,4350700,4609400,5090200,77958223,94636700,103031365,112190977,7.99575655180543,0.36277427194523854
South Korea,Guinea,138,159,172,313,486,426,407,269,1.9492753623188406,34,0.19767441860465115,-79,-0.16255144032921812,-19,-0.04460093896713615,KOR,GIN,47008111,49554112,51014947,51836239,8336967,10270728,11625998,13205153,0.7851649885324435,3.0821301351071053
North Korea,Denmark,163,211,258,305,336,375,406,243,1.49079754601227,95,0.3682170542635659,70,0.20833333333333334,31,0.08266666666666667,PRK,DNK,23367059,24686435,25258015,25867467,5339616,5547683,5683483,5831404,1.5695390661946143,6.962302731897841
Bahrain,Sri Lanka,4,50,97,194,393,398,402,398,99.5,93,0.9587628865979382,9,0.022900763358778626,4,0.010050251256281407,BHR,LKA,711442,1213645,1362142,1477469,18776371,20668557,21336697,21919000,27.208692703535576,1.8340252748756787
Sri Lanka,Libya,710,486,270,298,328,366,391,-319,-0.44929577464788734,-440,-1.6296296296296295,63,0.19207317073170732,25,0.06830601092896176,LKA,LBY,18776371,20668557,21336697,21919000,5154790,6491988,6192235,6653942,1.7838405036726128,5.876215933351989
India,Iceland,62,105,148,213,272,305,389,327,5.274193548387097,86,0.581081081081081,117,0.43014705882352944,84,0.2754098360655738,IND,ISL,1059633675,1240613620,1322866505,1396387127,281205,318041,330815,366463,0.027857604275952335,106.14987051898828
Myanmar,Switzerland,110,133,157,184,208,281,387,277,2.518181818181818,47,0.29936305732484075,179,0.8605769230769231,106,0.37722419928825623,MMR,CHE,45538332,49390988,51483949,53423198,7184250,7824909,8282396,8638167,0.7244044057414908,4.480117135961831
Turkey,Iran,393,590,1110,1099,1558,910,384,-9,-0.022900763358778626,717,0.6459459459459459,-1174,-0.7535301668806161,-526,-0.578021978021978,TUR,IRN,64113547,73142150,78218479,83384680,65544383,75373855,81790841,87290193,0.4605162483084423,0.4399119612440312
Philippines,Trinidad and Tobago,187,169,184,197,334,346,383,196,1.0481283422459893,-3,-0.016304347826086956,49,0.1467065868263473,37,0.1069364161849711,PHL,TTO,77958223,94636700,103031365,112190977,1332203,1410296,1460177,1518147,0.341382177285077,25.22812349528735
Thailand,Greece,326,321,322,354,400,376,383,57,0.17484662576687116,-4,-0.012422360248447204,-17,-0.0425,7,0.018617021276595744,THA,GRC,63066603,68270489,70294397,71475664,10805808,11121341,10820883,10698599,0.5358467184019444,3.579907986083038
Indonesia,Pakistan,599,502,443,423,413,408,380,-219,-0.3656093489148581,-156,-0.35214446952595935,-33,-0.07990314769975787,-28,-0.06862745098039216,IDN,PAK,214072421,244016173,259091970,271857970,154369924,194454498,210969298,227196741,0.13977887056244848,0.1672559202774832
Bhutan,Norway,5,8,15,22,233,365,373,368,73.6,10,0.6666666666666666,140,0.6008583690987125,8,0.021917808219178082,BTN,NOR,587207,705516,743274,772506,4490967,4889252,5188607,5379475,48.28441461943338,6.9337621236273055
Vietnam,Guam,352,352,351,351,351,354,373,21,0.05965909090909091,-1,-0.002849002849002849,22,0.06267806267806268,19,0.05367231638418079,VNM,GUM,79001142,87411012,92191398,96648685,160188,164905,167978,169231,0.38593385931738233,220.40879035164951
Maldives,United Kingdom,27,107,190,263,277,331,372,345,12.777777777777779,163,0.8578947368421053,95,0.34296028880866425,41,0.12386706948640483,MDV,GBR,282507,361575,435582,514438,58892514,62766365,65116219,67081234,72.31192097006831,0.554551515853152
Bangladesh,Northern Mariana Islands,434,590,783,698,413,370,371,-63,-0.14516129032258066,349,0.44572158365261816,-42,-0.1016949152542373,1,0.002702702702702703,BGD,MNP,129193327,148391139,157830000,167420951,80338,54087,51514,49587,0.22159711659982148,748.1799665234839
India,North Korea,178,198,217,274,330,363,370,192,1.0786516853932584,39,0.17972350230414746,40,0.12121212121212122,7,0.01928374655647383,IND,PRK,1059633675,1240613620,1322866505,1396387127,23367059,24686435,25258015,25867467,0.026496950082525363,1.4303681145123333
Philippines,Timor-Leste,591,629,673,731,762,377,370,-221,-0.3739424703891709,82,0.12184249628528974,-392,-0.5144356955380578,-7,-0.01856763925729443,PHL,TLS,77958223,94636700,103031365,112190977,878360,1088486,1205813,1299995,0.32979479267748957,28.461647929415115
China,Latvia,24,175,326,281,230,268,369,345,14.375,302,0.9263803680981595,139,0.6043478260869565,101,0.376865671641791,CHN,LVA,1262645000,1337705000,1379860000,1411100000,2367550,2097555,1977527,1900449,0.026149812203245696,19.416464214509308
India,Aruba,39,98,157,238,315,330,368,329,8.435897435897436,118,0.7515923566878981,53,0.16825396825396827,38,0.11515151515151516,IND,ABW,1059633675,1240613620,1322866505,1396387127,89101,100341,104257,106585,0.02635372332532252,345.264343012619
Mongolia,Ireland,61,169,369,371,311,318,363,302,4.950819672131147,308,0.8346883468834688,52,0.16720257234726688,45,0.14150943396226415,MNG,IRL,2450979,2702520,2964749,3294335,3805174,4560155,4701957,4985382,11.018915805466051,7.281287572346512
Nepal,Luxembourg,30,28,27,23,20,30,362,332,11.066666666666666,-3,-0.1111111111111111,342,17.1,332,11.066666666666666,NPL,LUX,24559500,27161567,27610325,29348627,436300,506953,569604,630419,1.2334478202336348,57.42212718842548
Malaysia,Turkey,64,155,247,255,263,259,361,297,4.640625,183,0.7408906882591093,98,0.3726235741444867,102,0.3938223938223938,MYS,TUR,22945150,28717731,31068833,33199993,64113547,73142150,78218479,83384680,1.087349626850825,0.4329332438524679
Thailand,Philippines,180,242,120,97,335,340,360,180,1,-60,-0.5,25,0.07462686567164178,20,0.058823529411764705,THA,PHL,63066603,68270489,70294397,71475664,77958223,94636700,103031365,112190977,0.503667933745953,0.32088141990242225
Vietnam,Belarus,182,282,381,366,351,366,359,177,0.9725274725274725,199,0.5223097112860893,8,0.022792022792022793,-7,-0.01912568306010929,VNM,BLR,79001142,87411012,92191398,96648685,9979610,9483836,9461076,9379952,0.37144840615265484,3.8273116962645437
Iran,Nauru,0,0,0,0,31,372,356,356,1,0,0,325,10.483870967741936,-16,-0.043010752688172046,IRN,NRU,65544383,75373855,81790841,87290193,10377,10241,11185,12315,0.40783504740332055,2890.7835972391395
South Korea,Romania,10,8,8,6,26,23,349,339,33.9,-2,-0.25,323,12.423076923076923,326,14.173913043478262,KOR,ROU,47008111,49554112,51014947,51836239,22442971,20246871,19815616,19265250,0.6732741547858053,1.811551887465774
China,Costa Rica,252,190,222,147,288,291,348,96,0.38095238095238093,-30,-0.13513513513513514,60,0.20833333333333334,57,0.1958762886597938,CHN,CRI,1262645000,1337705000,1379860000,1411100000,3979193,4622252,4895242,5123105,0.024661611508752037,6.792755565228509
United Kingdom,Fiji,759,646,528,308,331,341,348,-411,-0.541501976284585,-231,-0.4375,17,0.0513595166163142,7,0.020527859237536656,GBR,FJI,58892514,62766365,65116219,67081234,832509,905169,917200,920422,0.5187739987013358,37.808744249920146
Mauritius,India,2547,1455,362,382,399,371,346,-2201,-0.8641539065567334,-2185,-6.035911602209945,-53,-0.13283208020050125,-25,-0.0673854447439353,MUS,IND,1186873,1250400,1262879,1266014,1059633675,1240613620,1322866505,1396387127,27.329871549603716,0.024778228996091282
China,Gabon,107,143,179,195,226,316,344,237,2.2149532710280373,72,0.4022346368715084,118,0.5221238938053098,28,0.08860759493670886,CHN,GAB,1262645000,1337705000,1379860000,1411100000,1272935,1711105,2028517,2292573,0.024378144709800865,15.004974759800453
Nepal,Sri Lanka,4,43,84,167,337,340,343,339,84.75,80,0.9523809523809523,6,0.017804154302670624,3,0.008823529411764706,NPL,LKA,24559500,27161567,27610325,29348627,18776371,20668557,21336697,21919000,1.1687088462434716,1.5648524111501438
China,Haiti,348,330,313,297,311,326,341,-7,-0.020114942528735632,-35,-0.11182108626198083,30,0.09646302250803858,15,0.046012269938650305,CHN,HTI,1262645000,1337705000,1379860000,1411100000,8360225,9842880,10563757,11306801,0.024165544610587484,3.015883979916158
China,Uganda,137,129,374,362,364,366,341,204,1.489051094890511,237,0.6336898395721925,-23,-0.06318681318681318,-25,-0.06830601092896176,CHN,UGA,1262645000,1337705000,1379860000,1411100000,24020697,32341728,37477356,44404611,0.024165544610587484,0.7679382665912781
Afghanistan,Libya,677,452,236,260,285,319,340,-337,-0.4977843426883309,-441,-1.86864406779661,55,0.19298245614035087,21,0.06583072100313479,AFG,LBY,19542982,28189672,33753499,38972230,5154790,6491988,6192235,6653942,0.8724160767808258,5.1097529855234685
Canada,North Korea,149,179,209,255,301,331,337,188,1.261744966442953,60,0.28708133971291866,36,0.11960132890365449,6,0.01812688821752266,CAN,PRK,30685730,34005902,35704498,38028638,23367059,24686435,25258015,25867467,0.8861742563591154,1.3027947421369088
Hong Kong,Panama,187,270,371,277,240,281,337,150,0.8021390374331551,184,0.49595687331536387,97,0.4041666666666667,56,0.199288256227758,HKG,PAN,6665000,7024200,7291300,7481000,3001731,3623617,3957099,4294396,4.504745354899077,7.847436519594374
Bhutan,United Kingdom,11,48,86,239,251,299,336,325,29.545454545454547,75,0.872093023255814,85,0.3386454183266932,37,0.12374581939799331,BTN,GBR,587207,705516,743274,772506,58892514,62766365,65116219,67081234,43.494807807318004,0.5008852401254276
Indonesia,Czechia,22,33,43,84,118,179,333,311,14.136363636363637,21,0.4883720930232558,215,1.8220338983050848,154,0.8603351955307262,IDN,CZE,214072421,244016173,259091970,271857970,10255063,10474410,10546059,10697858,0.12249043130867195,3.1127726690707616
Fiji,American Samoa,50,101,152,243,333,332,332,282,5.64,102,0.6710526315789473,-1,-0.003003003003003003,0,0,FJI,ASM,832509,905169,917200,920422,58230,54849,51368,46189,36.0704111809583,718.7858581047436
Portugal,India,454,323,191,299,383,356,332,-122,-0.2687224669603524,-263,-1.3769633507853403,-51,-0.13315926892950392,-24,-0.06741573033707865,PRT,IND,10289898,10573100,10358076,10297081,1059633675,1240613620,1322866505,1396387127,3.224214707061156,0.023775641695671403
Oman,Sri Lanka,3,41,81,161,325,328,331,328,109.33333333333333,78,0.9629629629629629,6,0.018461538461538463,3,0.009146341463414634,OMN,LKA,2344253,2881914,4191776,4543399,18776371,20668557,21336697,21919000,7.285294555904071,1.5101053880195265
Pakistan,Maldives,79,92,100,104,203,303,329,250,3.1645569620253164,21,0.21,126,0.6206896551724138,26,0.0858085808580858,PAK,MDV,154369924,194454498,210969298,227196741,282507,361575,435582,514438,0.14480841518761045,63.953284943958266
New Zealand,Vanuatu,154,165,173,251,299,318,325,171,1.1103896103896105,19,0.10982658959537572,26,0.08695652173913043,7,0.0220125786163522,NZL,VUT,3857700,4350700,4609400,5090200,192074,245453,276438,311685,6.384817885348316,104.27194122270883
Thailand,Maldives,67,78,84,87,193,299,325,258,3.8507462686567164,17,0.20238095238095238,132,0.6839378238341969,26,0.08695652173913043,THA,MDV,63066603,68270489,70294397,71475664,282507,361575,435582,514438,0.45470021796509646,63.1757374066457
Indonesia,Sri Lanka,3,40,79,157,317,320,323,320,106.66666666666667,76,0.9620253164556962,6,0.01892744479495268,3,0.009375,IDN,LKA,214072421,244016173,259091970,271857970,18776371,20668557,21336697,21919000,0.11881203997808121,1.4736073725991148
Cambodia,Finland,62,73,83,157,214,256,320,258,4.161290322580645,21,0.25301204819277107,106,0.4953271028037383,64,0.25,KHM,FIN,12118841,14363532,15417523,16396860,5176209,5363352,5479531,5529543,1.9515931708875967,5.787096691354059
Thailand,Malta,42,50,63,75,87,148,320,278,6.619047619047619,21,0.3333333333333333,233,2.67816091954023,172,1.162162162162162,THA,MLT,63066603,68270489,70294397,71475664,390087,414508,445053,515332,0.4477048299964027,62.0958915805733
China,Marshall Islands,40,89,153,231,296,318,318,278,6.95,113,0.738562091503268,22,0.07432432432432433,0,0,CHN,MHL,1262645000,1337705000,1379860000,1411100000,54224,53416,49410,43413,0.022535610516618242,732.4994817220648
Afghanistan,Iraq,241,284,269,313,320,312,314,73,0.3029045643153527,28,0.10408921933085502,-6,-0.01875,2,0.00641025641025641,AFG,IRQ,19542982,28189672,33753499,38972230,24628858,31264875,37757813,42556984,0.8057019062034685,0.7378342412610819
Mongolia,Italy,5,31,57,166,249,291,314,309,61.8,52,0.9122807017543859,65,0.26104417670682734,23,0.07903780068728522,MNG,ITA,2450979,2702520,2964749,3294335,56942108,59277417,60730582,59438851,9.531513947427932,0.5282740071809262
Thailand,Slovenia,5,10,15,76,197,220,314,309,61.8,10,0.6666666666666666,117,0.5939086294416244,94,0.42727272727272725,THA,SVN,63066603,68270489,70294397,71475664,1988925,2048583,2063531,2102419,0.43931036443397015,14.935177050816225
Iran,Mexico,58,150,249,247,274,285,312,254,4.379310344827586,191,0.7670682730923695,38,0.1386861313868613,27,0.09473684210526316,IRN,MEX,65544383,75373855,81790841,87290193,97873442,112532401,120149897,125998302,0.3574284685107753,0.247622384625469
China,Pakistan,490,410,363,347,338,334,311,-179,-0.3653061224489796,-127,-0.349862258953168,-27,-0.07988165680473373,-23,-0.0688622754491018,CHN,PAK,1262645000,1337705000,1379860000,1411100000,154369924,194454498,210969298,227196741,0.02203954361845369,0.13688576633236124
United Kingdom,North Korea,188,205,221,249,276,304,309,121,0.6436170212765957,33,0.1493212669683258,33,0.11956521739130435,5,0.01644736842105263,GBR,PRK,58892514,62766365,65116219,67081234,23367059,24686435,25258015,25867467,0.4606355333296343,1.1945506686062457
Laos,Philippines,4321,5815,532,430,372,287,304,-4017,-0.9296459152973848,-3789,-7.12218045112782,-68,-0.1827956989247312,17,0.059233449477351915,LAO,PHL,5430853,6323418,6787419,7319399,77958223,94636700,103031365,112190977,4.153346470113188,0.2709665323620455
Samoa,Fiji,271,267,266,267,287,296,302,31,0.11439114391143912,-5,-0.018796992481203006,15,0.05226480836236934,6,0.02027027027027027,WSM,FJI,184008,194672,203571,214929,832509,905169,917200,920422,140.51151775702675,32.81103667665484
South Korea,Costa Rica,148,136,193,128,251,253,302,154,1.0405405405405406,45,0.23316062176165803,51,0.20318725099601595,49,0.19367588932806323,KOR,CRI,47008111,49554112,51014947,51836239,3979193,4622252,4895242,5123105,0.5826039964049089,5.8948625882155445
Iran,Poland,197,168,144,188,239,227,301,104,0.5279187817258884,-53,-0.3680555555555556,62,0.2594142259414226,74,0.32599118942731276,IRN,POL,65544383,75373855,81790841,87290193,38258629,38042794,37986412,37899070,0.344826823787639,0.794214739306268
Pakistan,Timor-Leste,190,207,226,240,245,306,301,111,0.5842105263157895,36,0.1592920353982301,56,0.22857142857142856,-5,-0.016339869281045753,PAK,TLS,154369924,194454498,210969298,227196741,878360,1088486,1205813,1299995,0.1324842947461117,23.153935207443105
Bhutan,Netherlands,9,13,19,48,195,310,300,291,32.333333333333336,10,0.5263157894736842,105,0.5384615384615384,-10,-0.03225806451612903,BTN,NLD,587207,705516,743274,772506,15925513,16615394,16939923,17441500,38.8346498279625,1.7200355474013131
France,Sri Lanka,50,78,107,168,294,297,300,250,5,57,0.5327102803738317,6,0.02040816326530612,3,0.010101010101010102,FRA,LKA,60921384,65030575,66548272,67571107,18776371,20668557,21336697,21919000,0.44397674289989064,1.3686755782654318
India,Serbia,36,229,312,308,302,295,299,263,7.305555555555555,276,0.8846153846153846,-3,-0.009933774834437087,4,0.013559322033898305,IND,SRB,1059633675,1240613620,1322866505,1396387127,7516346,7291436,7095383,6899126,0.021412400201824548,4.333882291756956
South Korea,Egypt,282,240,218,260,281,193,299,17,0.06028368794326241,-64,-0.29357798165137616,18,0.06405693950177936,106,0.5492227979274611,KOR,EGY,47008111,49554112,51014947,51836239,71371371,87252413,97723799,107465134,0.5768165394869793,0.2782297745052828
Vietnam,Mongolia,11,11,13,112,225,278,297,286,26,2,0.15384615384615385,72,0.32,19,0.0683453237410072,VNM,MNG,79001142,87411012,92191398,96648685,2450979,2702520,2964749,3294335,0.3072985421374331,9.015476568108587
South Korea,American Samoa,201,192,182,239,296,295,295,94,0.46766169154228854,-19,-0.1043956043956044,-1,-0.0033783783783783786,0,0,KOR,ASM,47008111,49554112,51014947,51836239,58230,54849,51368,46189,0.5690999302630733,638.6802052436727
France,Cambodia,128,336,543,424,305,275,294,166,1.296875,415,0.7642725598526704,-11,-0.036065573770491806,19,0.06909090909090909,FRA,KHM,60921384,65030575,66548272,67571107,12118841,14363532,15417523,16396860,0.4350972080418928,1.7930262257529797
Pakistan,Bulgaria,23,25,27,33,37,137,290,267,11.608695652173912,4,0.14814814814814814,253,6.837837837837838,153,1.1167883211678833,PAK,BGR,154369924,194454498,210969298,227196741,8170172,7395599,7177991,6934015,0.1276426760012372,4.182281117072864
Switzerland,Sri Lanka,6,39,73,142,284,288,290,284,47.333333333333336,67,0.9178082191780822,6,0.02112676056338028,2,0.006944444444444444,CHE,LKA,7184250,7824909,8282396,8638167,18776371,20668557,21336697,21919000,3.3571937194546018,1.3230530589899174
Cambodia,Denmark,50,90,129,162,186,234,288,238,4.76,79,0.6124031007751938,102,0.5483870967741935,54,0.23076923076923078,KHM,DNK,12118841,14363532,15417523,16396860,5339616,5547683,5683483,5831404,1.7564338537988369,4.938776322134429
Laos,Argentina,539,566,593,1333,282,283,284,-255,-0.47309833024118736,54,0.09106239460370995,2,0.0070921985815602835,1,0.0035335689045936395,LAO,ARG,5430853,6323418,6787419,7319399,37070774,40788453,43131966,45376763,3.880099991816268,0.6258709992160525
Indonesia,Portugal,28,59,94,170,218,247,282,254,9.071428571428571,66,0.7021276595744681,64,0.29357798165137616,35,0.1417004048582996,IDN,PRT,214072421,244016173,259091970,271857970,10289898,10573100,10358076,10297081,0.10373063552265914,2.7386402029856813
Malaysia,Jordan,983,664,345,259,534,220,282,-701,-0.7131230925737538,-638,-1.8492753623188405,-252,-0.47191011235955055,62,0.2818181818181818,MYS,JOR,22945150,28717731,31068833,33199993,5056174,6931258,9494246,10928721,0.8493977694513369,2.5803568413906803
Pakistan,Luxembourg,0,0,0,0,0,0,279,279,1,0,0,279,1,279,1,PAK,LUX,154369924,194454498,210969298,227196741,436300,506953,569604,630419,0.12280105725636267,44.25628034688041
Laos,Cambodia,121,317,513,400,288,260,278,157,1.2975206611570247,392,0.7641325536062378,-10,-0.034722222222222224,18,0.06923076923076923,LAO,KHM,5430853,6323418,6787419,7319399,12118841,14363532,15417523,16396860,3.7981260483271915,1.6954465672085997
Pakistan,Poland,85,72,62,139,221,210,278,193,2.2705882352941176,-23,-0.3709677419354839,57,0.2579185520361991,68,0.3238095238095238,PAK,POL,154369924,194454498,210969298,227196741,38258629,38042794,37986412,37899070,0.12236091009773771,0.7335272343094434
Afghanistan,Belarus,140,216,292,281,270,282,277,137,0.9785714285714285,152,0.5205479452054794,7,0.025925925925925925,-5,-0.01773049645390071,AFG,BLR,19542982,28189672,33753499,38972230,9979610,9483836,9461076,9379952,0.7107625096126139,2.953106796282113
Jordan,Sri Lanka,3,34,67,134,271,274,276,273,91,64,0.9552238805970149,5,0.01845018450184502,2,0.0072992700729927005,JOR,LKA,5056174,6931258,9494246,10928721,18776371,20668557,21336697,21919000,2.5254556319993897,1.2591815320041972
Thailand,Sri Lanka,3,34,67,134,271,274,276,273,91,64,0.9552238805970149,5,0.01845018450184502,2,0.0072992700729927005,THA,LKA,63066603,68270489,70294397,71475664,18776371,20668557,21336697,21919000,0.3861454158718974,1.2591815320041972
Qatar,Sri Lanka,3,34,67,134,270,273,275,272,90.66666666666667,64,0.9552238805970149,5,0.018518518518518517,2,0.007326007326007326,QAT,LKA,645937,1713504,2414573,2760385,18776371,20668557,21336697,21919000,9.962378436341307,1.2546192800766458
North Korea,Switzerland,106,233,361,389,478,366,273,167,1.5754716981132075,255,0.7063711911357341,-205,-0.42887029288702927,-93,-0.2540983606557377,PRK,CHE,23367059,24686435,25258015,25867467,7184250,7824909,8282396,8638167,1.055379716923965,3.1603927083141596
Hong Kong,Philippines,196,263,268,216,252,256,272,76,0.3877551020408163,72,0.26865671641791045,20,0.07936507936507936,16,0.0625,HKG,PHL,6665000,7024200,7291300,7481000,77958223,94636700,103031365,112190977,3.635877556476407,0.24244373948183015
Australia,Solomon Islands,360,356,340,309,298,279,271,-89,-0.24722222222222223,-20,-0.058823529411764705,-27,-0.09060402684563758,-8,-0.02867383512544803,AUS,SLB,19028802,22031750,23815995,25649248,429978,540394,612660,691191,1.056561190409949,39.20768644267648
Germany,Maldives,251,213,162,176,213,250,271,20,0.0796812749003984,-89,-0.5493827160493827,58,0.27230046948356806,21,0.084,DEU,MDV,82211508,81776930,81686611,83160871,282507,361575,435582,514438,0.3258744127391355,52.67884565292611
Portugal,Timor-Leste,258,281,308,327,334,276,271,13,0.050387596899224806,50,0.16233766233766234,-63,-0.18862275449101795,-5,-0.018115942028985508,PRT,TLS,10289898,10573100,10358076,10297081,878360,1088486,1205813,1299995,2.631813812089076,20.846234023977015
Sri Lanka,Ireland,46,127,278,278,233,238,271,225,4.891304347826087,232,0.8345323741007195,38,0.1630901287553648,33,0.13865546218487396,LKA,IRL,18776371,20668557,21336697,21919000,3805174,4560155,4701957,4985382,1.23637027236644,5.435892374947397
Bhutan,Belgium,158,158,153,236,272,280,269,111,0.7025316455696202,-5,-0.032679738562091505,-3,-0.011029411764705883,-11,-0.039285714285714285,BTN,BEL,587207,705516,743274,772506,10251250,10895586,11274196,11538604,34.821736012406376,2.3313045494931623
North Korea,Australia,50,237,380,430,230,220,268,218,4.36,330,0.868421052631579,38,0.16521739130434782,48,0.21818181818181817,PRK,AUS,23367059,24686435,25258015,25867467,19028802,22031750,23815995,25649248,1.0360504180792034,1.0448649410696174
China,Ghana,121,121,135,190,189,232,266,145,1.1983471074380165,14,0.1037037037037037,77,0.4074074074074074,34,0.14655172413793102,CHN,GHA,1262645000,1337705000,1379860000,1411100000,19665502,25574719,28870939,32180401,0.018850542130252994,0.8265900726345827
Bangladesh,Estonia,0,0,0,0,12,35,263,263,1,0,0,251,20.916666666666668,228,6.514285714285714,BGD,EST,129193327,148391139,157830000,167420951,1396985,1331475,1315407,1329522,0.157089061093674,19.781545547948813
China,El Salvador,260,224,187,218,248,259,262,2,0.007692307692307693,-73,-0.39037433155080214,14,0.056451612903225805,3,0.011583011583011582,CHN,SLV,1262645000,1337705000,1379860000,1411100000,5958482,6114034,6231066,6292731,0.01856707533130182,4.163534084008994
China,Kyrgyzstan,770,612,438,375,308,271,262,-508,-0.6597402597402597,-332,-0.7579908675799086,-46,-0.14935064935064934,-9,-0.033210332103321034,CHN,KGZ,1262645000,1337705000,1379860000,1411100000,4898400,5447900,5956900,6579900,0.01856707533130182,3.981823431967051
New Caledonia,Vanuatu,163,161,146,197,242,257,262,99,0.6073619631901841,-17,-0.11643835616438356,20,0.08264462809917356,5,0.019455252918287938,NCL,VUT,213230,249750,269460,271080,192074,245453,276438,311685,96.65043529585361,84.0592264626145
South Africa,Sri Lanka,3,33,64,127,257,260,262,259,86.33333333333333,61,0.953125,5,0.019455252918287938,2,0.007692307692307693,ZAF,LKA,46813266,51784921,55876504,58801927,18776371,20668557,21336697,21919000,0.44556362923276305,1.195310005018477
Pakistan,Estonia,0,0,0,0,32,72,261,261,1,0,0,229,7.15625,189,2.625,PAK,EST,154369924,194454498,210969298,227196741,1396985,1331475,1315407,1329522,0.11487840840111346,19.631115543781902
South Korea,Venezuela (Bolivarian Republic of),245,242,237,249,265,277,260,15,0.061224489795918366,-8,-0.03375527426160337,-5,-0.018867924528301886,-17,-0.061371841155234655,KOR,VEN,47008111,49554112,51014947,51836239,24427729,28715022,30529716,28490453,0.5015795995538951,0.9125864021888314
Mongolia,Turkey,46,111,178,184,189,187,259,213,4.630434782608695,132,0.7415730337078652,70,0.37037037037037035,72,0.3850267379679144,MNG,TUR,2450979,2702520,2964749,3294335,64113547,73142150,78218479,83384680,7.8619812496300465,0.3106086153955379
Hungary,Philippines,3,4,125,101,240,244,258,255,85,122,0.976,18,0.075,14,0.05737704918032787,HUN,PHL,10210971,10000023,9843028,9750149,77958223,94636700,103031365,112190977,2.6461134081130453,0.22996501759673593
Japan,Papua New Guinea,263,269,201,301,255,258,258,-5,-0.019011406844106463,-62,-0.30845771144278605,3,0.011764705882352941,0,0,JPN,PNG,126843000,128070000,127141000,126261000,5508297,7583269,8682174,9749640,0.20433863188157864,2.6462515539035287
Kiribati,Solomon Islands,991,980,934,590,283,265,258,-733,-0.739656912209889,-57,-0.061027837259100645,-25,-0.08833922261484099,-7,-0.026415094339622643,KIR,SLB,88826,107995,116707,126463,429978,540394,612660,691191,204.01224073444408,37.32687491590602
Myanmar,South Africa,211,131,91,119,173,223,258,47,0.22274881516587677,-120,-1.3186813186813187,85,0.4913294797687861,35,0.15695067264573992,MMR,ZAF,45538332,49390988,51483949,53423198,46813266,51784921,55876504,58801927,0.4829362704943272,0.4387611310765377
Philippines,Namibia,364,348,325,256,246,240,256,-108,-0.2967032967032967,-39,-0.12,10,0.04065040650406504,16,0.06666666666666667,PHL,NAM,77958223,94636700,103031365,112190977,1819141,2099271,2282704,2489098,0.22818234304172252,10.284850174641576
Thailand,Cyprus,65,92,119,179,273,250,256,191,2.9384615384615387,54,0.453781512605042,-17,-0.06227106227106227,6,0.024,THA,CYP,63066603,68270489,70294397,71475664,948237,1129686,1187280,1237537,0.35816386399712213,20.686250188883243
Bangladesh,Egypt,112,143,186,221,239,164,255,143,1.2767857142857142,74,0.3978494623655914,16,0.06694560669456066,91,0.5548780487804879,BGD,EGY,129193327,148391139,157830000,167420951,71371371,87252413,97723799,107465134,0.15231068661173713,0.2372862625379502
Philippines,Poland,67,57,49,123,202,191,254,187,2.791044776119403,-18,-0.3673469387755102,52,0.25742574257425743,63,0.3298429319371728,PHL,POL,77958223,94636700,103031365,112190977,38258629,38042794,37986412,37899070,0.22639966848670903,0.670201142138844
Canada,Sri Lanka,2,31,61,122,247,250,251,249,124.5,59,0.9672131147540983,4,0.016194331983805668,1,0.004,CAN,LKA,30685730,34005902,35704498,38028638,18776371,20668557,21336697,21919000,0.6600288971695488,1.1451252338154112
Cyprus,Sri Lanka,2,31,61,122,247,250,251,249,124.5,59,0.9672131147540983,4,0.016194331983805668,1,0.004,CYP,LKA,948237,1129686,1187280,1237537,18776371,20668557,21336697,21919000,20.282221864881617,1.1451252338154112
Laos,Italy,77,128,179,220,268,250,251,174,2.25974025974026,102,0.5698324022346368,-17,-0.06343283582089553,1,0.004,LAO,ITA,5430853,6323418,6787419,7319399,56942108,59277417,60730582,59438851,3.42924330262635,0.42228272548539003
Laos,Spain,20,31,376,181,203,188,251,231,11.55,356,0.9468085106382979,48,0.23645320197044334,63,0.3351063829787234,LAO,ESP,5430853,6323418,6787419,7319399,40567864,46576897,46444832,47365655,3.42924330262635,0.5299198332631524
Papua New Guinea,Canada,106,199,297,399,410,233,251,145,1.3679245283018868,191,0.6430976430976431,-159,-0.3878048780487805,18,0.07725321888412018,PNG,CAN,5508297,7583269,8682174,9749640,30685730,34005902,35704498,38028638,2.5744540311232003,0.6600288971695488
Papua New Guinea,Switzerland,158,168,180,199,238,253,251,93,0.5886075949367089,22,0.12222222222222222,13,0.0546218487394958,-2,-0.007905138339920948,PNG,CHE,5508297,7583269,8682174,9749640,7184250,7824909,8282396,8638167,2.5744540311232003,2.9057090468382936
Australia,Mongolia,3,3,4,91,189,233,248,245,81.66666666666667,1,0.25,59,0.31216931216931215,15,0.06437768240343347,AUS,MNG,19028802,22031750,23815995,25649248,2450979,2702520,2964749,3294335,0.9668899454674071,7.528074710070469
Bangladesh,Hungary,60,53,46,57,68,67,244,184,3.066666666666667,-14,-0.30434782608695654,176,2.588235294117647,177,2.6417910447761193,BGD,HUN,129193327,148391139,157830000,167420951,10210971,10000023,9843028,9750149,0.14574042169907397,2.502525858835593
Indonesia,Turkey,43,104,167,173,178,176,244,201,4.674418604651163,124,0.7425149700598802,66,0.3707865168539326,68,0.38636363636363635,IDN,TUR,214072421,244016173,259091970,271857970,64113547,73142150,78218479,83384680,0.08975274846641428,0.29261969944598937
India,Venezuela (Bolivarian Republic of),229,226,221,232,246,258,242,13,0.056768558951965066,-8,-0.03619909502262444,-4,-0.016260162601626018,-16,-0.06201550387596899,IND,VEN,1059633675,1240613620,1322866505,1396387127,24427729,28715022,30529716,28490453,0.017330437621543616,0.8494073435757585
Thailand,Seychelles,5,237,469,341,214,239,242,237,47.4,464,0.9893390191897654,28,0.1308411214953271,3,0.012552301255230125,THA,SYC,63066603,68270489,70294397,71475664,81131,89770,93419,98462,0.33857677768477956,245.78009790579108
India,Ecuador,76,86,95,114,181,228,238,162,2.1315789473684212,19,0.2,57,0.3149171270718232,10,0.043859649122807015,IND,ECU,1059633675,1240613620,1322866505,1396387127,12626507,14989585,16195902,17588595,0.017043984107137936,1.3531495835795866
Turkey,Mongolia,109,120,133,148,180,222,236,127,1.165137614678899,24,0.18045112781954886,56,0.3111111111111111,14,0.06306306306306306,TUR,MNG,64113547,73142150,78218479,83384680,2450979,2702520,2964749,3294335,0.28302561093956347,7.163813030550931
Canada,Papua New Guinea,358,366,274,274,232,235,235,-123,-0.3435754189944134,-84,-0.30656934306569344,3,0.01293103448275862,0,0,CAN,PNG,30685730,34005902,35704498,38028638,5508297,7583269,8682174,9749640,0.6179553419714899,2.4103454076253072
Fiji,Vanuatu,166,146,129,176,216,230,235,69,0.41566265060240964,-37,-0.2868217054263566,19,0.08796296296296297,5,0.021739130434782608,FJI,VUT,832509,905169,917200,920422,192074,245453,276438,311685,25.531766950377108,75.39663442257407
India,Iraq,179,211,200,233,238,232,234,55,0.30726256983240224,21,0.105,-4,-0.01680672268907563,2,0.008620689655172414,IND,IRQ,1059633675,1240613620,1322866505,1396387127,24628858,31264875,37757813,42556984,0.016757530592732255,0.5498509950799145
India,Slovenia,11,22,19,49,83,143,234,223,20.272727272727273,8,0.42105263157894735,151,1.819277108433735,91,0.6363636363636364,IND,SVN,1059633675,1240613620,1322866505,1396387127,1988925,2048583,2063531,2102419,0.016757530592732255,11.130036400926743
Bhutan,Sri Lanka,2,28,56,113,229,231,233,231,115.5,54,0.9642857142857143,4,0.017467248908296942,2,0.008658008658008658,BTN,LKA,587207,705516,743274,772506,18776371,20668557,21336697,21919000,30.161578033050873,1.0630046991194855
Iraq,Pakistan,894,466,586,289,287,251,233,-661,-0.7393736017897091,-308,-0.5255972696245734,-54,-0.18815331010452963,-18,-0.07171314741035857,IRQ,PAK,24628858,31264875,37757813,42556984,154369924,194454498,210969298,227196741,0.5475012045026499,0.1025542879596147
South Korea,Bulgaria,33,43,53,41,51,140,230,197,5.96969696969697,20,0.37735849056603776,179,3.5098039215686274,90,0.6428571428571429,KOR,BGR,47008111,49554112,51014947,51836239,8170172,7395599,7177991,6934015,0.4437050303745996,3.3169815756095136
China,Nauru,504,466,428,402,125,198,229,-275,-0.5456349206349206,-76,-0.17757009345794392,104,0.832,31,0.15656565656565657,CHN,NRU,1262645000,1337705000,1379860000,1411100000,10377,10241,11185,12315,0.016228474239954646,1859.5209094600082
Pakistan,Latvia,16,25,34,34,35,24,228,212,13.25,18,0.5294117647058824,193,5.514285714285714,204,8.5,PAK,LVA,154369924,194454498,210969298,227196741,2367550,2097555,1977527,1900449,0.10035355216648993,11.997164880509818
Kazakhstan,Mongolia,528,583,644,384,170,210,225,-303,-0.5738636363636364,116,0.18012422360248448,55,0.3235294117647059,15,0.07142857142857142,KAZ,MNG,14883626,16321872,17542806,18755666,2450979,2702520,2964749,3294335,1.1996374855470342,6.829906490991354
South Korea,Kyrgyzstan,1459,1067,648,460,265,233,225,-1234,-0.8457847840986977,-811,-1.251543209876543,-40,-0.1509433962264151,-8,-0.034334763948497854,KOR,KGZ,47008111,49554112,51014947,51836239,4898400,5447900,5956900,6579900,0.4340592688447169,3.4195048556968954
Bangladesh,Seychelles,11,14,17,107,197,220,223,212,19.272727272727273,6,0.35294117647058826,26,0.1319796954314721,3,0.013636363636363636,BGD,SYC,129193327,148391139,157830000,167420951,81131,89770,93419,98462,0.13319718868398972,226.48331335946864
Bangladesh,Nepal,500,577,522,453,244,233,222,-278,-0.556,22,0.0421455938697318,-22,-0.09016393442622951,-11,-0.04721030042918455,BGD,NPL,129193327,148391139,157830000,167420951,24559500,27161567,27610325,29348627,0.13259989187374763,0.7564238013587484
Sri Lanka,Egypt,249,199,164,195,210,144,222,-27,-0.10843373493975904,-85,-0.5182926829268293,12,0.05714285714285714,78,0.5416666666666666,LKA,EGY,18776371,20668557,21336697,21919000,71371371,87252413,97723799,107465134,1.0128199279164196,0.2065786285624508
China,Lesotho,162,140,114,116,118,168,221,59,0.36419753086419754,-48,-0.42105263157894735,103,0.8728813559322034,53,0.31547619047619047,CHN,LSO,1262645000,1337705000,1379860000,1411100000,1998630,2022747,2118521,2254100,0.0156615406420523,9.804356505922541
Laos,Netherlands,55,80,109,133,163,200,220,165,3,54,0.4954128440366973,57,0.3496932515337423,20,0.1,LAO,NLD,5430853,6323418,6787419,7319399,15925513,16615394,16939923,17441500,3.005711261266123,1.2613594014276295
Solomon Islands,Papua New Guinea,324,331,247,257,218,221,220,-104,-0.32098765432098764,-77,-0.3117408906882591,2,0.009174311926605505,-1,-0.004524886877828055,SLB,PNG,429978,540394,612660,691191,5508297,7583269,8682174,9749640,31.829118145346225,2.2564935730960323
Malaysia,Czechia,3,5,7,179,333,356,219,216,72,4,0.5714285714285714,-114,-0.34234234234234234,-137,-0.3848314606741573,MYS,CZE,22945150,28717731,31068833,33199993,10255063,10474410,10546059,10697858,0.6596386932973148,2.0471387823618525
South Korea,Ireland,37,102,224,225,189,193,219,182,4.918918918918919,187,0.8348214285714286,30,0.15873015873015872,26,0.13471502590673576,KOR,IRL,47008111,49554112,51014947,51836239,3805174,4560155,4701957,4985382,0.4224843550088578,4.392842915547896
Uzbekistan,Afghanistan,2027,1836,1646,1422,1199,751,219,-1808,-0.8919585594474593,-381,-0.23147023086269744,-980,-0.817347789824854,-532,-0.7083888149134487,UZB,AFG,24650400,28562400,31298900,34232050,19542982,28189672,33753499,38972230,0.6397513441351015,0.5619385906323554
Australia,Laos,18,18,17,16,110,205,218,200,11.11111111111111,-1,-0.058823529411764705,108,0.9818181818181818,13,0.06341463414634146,AUS,LAO,19028802,22031750,23815995,25649248,5430853,6323418,6787419,7319399,0.8499274520640918,2.978386613436431
Timor-Leste,Greece,0,3,6,114,230,215,217,217,1,6,1,-13,-0.05652173913043478,2,0.009302325581395349,TLS,GRC,878360,1088486,1205813,1299995,10805808,11121341,10820883,10698599,16.692371893738052,2.028302958172374
Iran,Estonia,0,0,0,0,28,75,216,216,1,0,0,188,6.714285714285714,141,1.88,IRN,EST,65544383,75373855,81790841,87290193,1396985,1331475,1315407,1329522,0.24745047819976754,16.2464404500264
France,Vietnam,21,53,127,145,170,205,215,194,9.238095238095237,106,0.8346456692913385,45,0.2647058823529412,10,0.04878048780487805,FRA,VNM,60921384,65030575,66548272,67571107,79001142,87411012,92191398,96648685,0.3181833324115883,0.22245517360117215
Thailand,Russian Federation,75,78,80,148,213,217,215,140,1.8666666666666667,5,0.0625,2,0.009389671361502348,-2,-0.009216589861751152,THA,RUS,63066603,68270489,70294397,71475664,146596869,142849468,144640716,145245148,0.30080168265383306,0.14802559876217
India,Saint Lucia,49,65,90,165,228,218,214,165,3.36734693877551,41,0.45555555555555555,-14,-0.06140350877192982,-4,-0.01834862385321101,IND,LCA,1059633675,1240613620,1322866505,1396387127,159500,170935,175623,179237,0.015325263020703857,119.39499098958363
Japan,North Korea,180,173,166,179,191,210,214,34,0.18888888888888888,-14,-0.08433734939759036,23,0.12041884816753927,4,0.01904761904761905,JPN,PRK,126843000,128070000,127141000,126261000,23367059,24686435,25258015,25867467,0.16949018303355748,0.827293990555782
Philippines,Faroe Islands,14,15,20,33,61,130,213,199,14.214285714285714,6,0.3,152,2.4918032786885247,83,0.6384615384615384,PHL,FRO,77958223,94636700,103031365,112190977,45660,48410,48816,52415,0.18985484010893316,406.3722216922637
South Korea,Greece,15,108,202,209,224,210,213,198,13.2,187,0.9257425742574258,-11,-0.049107142857142856,3,0.014285714285714285,KOR,GRC,47008111,49554112,51014947,51836239,10805808,11121341,10820883,10698599,0.4109094411729987,1.9909148852106713
Vietnam,Greece,713,465,224,220,223,209,212,-501,-0.7026647966339411,-489,-2.1830357142857144,-11,-0.04932735426008968,3,0.014354066985645933,VNM,GRC,79001142,87411012,92191398,96648685,10805808,11121341,10820883,10698599,0.21935114792301622,1.9815678669702452
Indonesia,Curaçao,0,0,0,0,169,182,211,211,1,0,0,42,0.2485207100591716,29,0.15934065934065933,IDN,CUW,214072421,244016173,259091970,271857970,133860,148703,157980,154947,0.07761405707546482,136.1755955262122
Afghanistan,Egypt,237,188,154,183,198,135,210,-27,-0.11392405063291139,-83,-0.538961038961039,12,0.06060606060606061,75,0.5555555555555556,AFG,EGY,19542982,28189672,33753499,38972230,71371371,87252413,97723799,107465134,0.5388452238940394,0.1954122162077237
Vanuatu,French Polynesia,187,205,220,230,222,210,210,23,0.12299465240641712,33,0.15,-12,-0.05405405405405406,0,0,VUT,PYF,192074,245453,276438,311685,250927,283788,291787,301920,67.37571586698108,69.55484896661366
Vietnam,American Samoa,1,102,203,208,212,211,210,209,209,202,0.9950738916256158,-2,-0.009433962264150943,-1,-0.004739336492890996,VNM,ASM,79001142,87411012,92191398,96648685,58230,54849,51368,46189,0.21728179747091234,454.65370542769926
Sri Lanka,Czechia,8,12,15,58,96,135,209,201,25.125,7,0.4666666666666667,113,1.1770833333333333,74,0.5481481481481482,LKA,CZE,18776371,20668557,21336697,21919000,10255063,10474410,10546059,10697858,0.9535106528582509,1.9536621256330005
United States of America,Cambodia,91,239,386,301,216,195,208,117,1.2857142857142858,295,0.7642487046632125,-8,-0.037037037037037035,13,0.06666666666666667,USA,KHM,282162411,309327143,320738994,331526933,12118841,14363532,15417523,16396860,0.06274000067439468,1.268535561076938
Australia,North Korea,96,112,127,155,183,202,204,108,1.125,31,0.2440944881889764,21,0.11475409836065574,2,0.009900990099009901,AUS,PRK,19028802,22031750,23815995,25649248,23367059,24686435,25258015,25867467,0.7953449551425446,0.7886353928662594
Nigeria,Philippines,45,60,321,259,189,192,204,159,3.533333333333333,276,0.8598130841121495,15,0.07936507936507936,12,0.0625,NGA,PHL,122851984,160952853,183995785,208327405,77958223,94636700,103031365,112190977,0.09792278649081239,0.1818328046113726
Vietnam,Timor-Leste,162,176,192,204,209,208,204,42,0.25925925925925924,30,0.15625,-5,-0.023923444976076555,-4,-0.019230769230769232,VNM,TLS,79001142,87411012,92191398,96648685,878360,1088486,1205813,1299995,0.21107374611460053,15.692368047569413
Iran,Ecuador,64,72,80,96,152,192,200,136,2.125,16,0.2,48,0.3157894736842105,8,0.041666666666666664,IRN,ECU,65544383,75373855,81790841,87290193,12626507,14989585,16195902,17588595,0.2291208131479329,1.137100490403014
Thailand,Turkey,35,85,136,141,145,144,199,164,4.685714285714286,101,0.7426470588235294,54,0.3724137931034483,55,0.3819444444444444,THA,TUR,63066603,68270489,70294397,71475664,64113547,73142150,78218479,83384680,0.27841644115401293,0.2386529515973438
Afghanistan,Turkmenistan,321,3210,1784,808,345,231,198,-123,-0.38317757009345793,1463,0.820067264573991,-147,-0.4260869565217391,-33,-0.14285714285714285,AFG,TKM,19542982,28189672,33753499,38972230,4569132,5267970,5766431,6250438,0.5080540682429514,3.1677780021176116
Malaysia,North Korea,127,138,149,164,178,196,198,71,0.5590551181102362,22,0.1476510067114094,20,0.11235955056179775,2,0.01020408163265306,MYS,PRK,22945150,28717731,31068833,33199993,23367059,24686435,25258015,25867467,0.5963856679126408,0.7654402342525458
Germany,Mongolia,50,54,60,98,148,183,195,145,2.9,10,0.16666666666666666,47,0.31756756756756754,12,0.06557377049180328,DEU,MNG,82211508,81776930,81686611,83160871,2450979,2702520,2964749,3294335,0.23448527853923032,5.919252292192506
Myanmar,Belgium,49,49,47,103,149,224,195,146,2.979591836734694,-2,-0.0425531914893617,46,0.3087248322147651,-29,-0.12946428571428573,MMR,BEL,45538332,49390988,51483949,53423198,10251250,10895586,11274196,11538604,0.3650099718852473,1.689979134390954
Afghanistan,Slovakia,26,125,315,488,139,155,194,168,6.461538461538462,289,0.9174603174603174,55,0.39568345323741005,39,0.25161290322580643,AFG,SVK,19542982,28189672,33753499,38972230,5388720,5391428,5423801,5458827,0.4977903496925888,3.5538770508755815
India,Slovakia,7,45,97,401,122,155,194,187,26.714285714285715,90,0.9278350515463918,72,0.5901639344262295,39,0.25161290322580643,IND,SVK,1059633675,1240613620,1322866505,1396387127,5388720,5391428,5423801,5458827,0.013892995448675458,3.5538770508755815
South Korea,Gabon,60,80,100,110,127,177,193,133,2.216666666666667,40,0.4,66,0.5196850393700787,16,0.0903954802259887,KOR,GAB,47008111,49554112,51014947,51836239,1272935,1711105,2028517,2292573,0.3723263950534683,8.418488746050834
China,Solomon Islands,241,239,228,213,211,197,192,-49,-0.2033195020746888,-13,-0.05701754385964912,-19,-0.09004739336492891,-5,-0.025380710659898477,CHN,SLB,1262645000,1337705000,1379860000,1411100000,429978,540394,612660,691191,0.013606406349656297,27.778139472302158
Vietnam,South Africa,156,97,68,89,129,166,192,36,0.23076923076923078,-88,-1.2941176470588236,63,0.4883720930232558,26,0.1566265060240964,VNM,ZAF,79001142,87411012,92191398,96648685,46813266,51784921,55876504,58801927,0.19865764340197697,0.3265199114988187
China,Lithuania,157,175,137,105,60,53,191,34,0.21656050955414013,-20,-0.145985401459854,131,2.183333333333333,138,2.6037735849056602,CHN,LTU,1262645000,1337705000,1379860000,1411100000,3499536,3097282,2904910,2794885,0.013535539649918504,6.833912665458508
Sri Lanka,Iceland,83,93,102,134,162,164,190,107,1.2891566265060241,19,0.18627450980392157,28,0.1728395061728395,26,0.15853658536585366,LKA,ISL,18776371,20668557,21336697,21919000,281205,318041,330815,366463,0.8668278662347735,51.846980459145946
China,Sierra Leone,280,273,266,221,207,195,187,-93,-0.33214285714285713,-14,-0.05263157894736842,-20,-0.0966183574879227,-8,-0.041025641025641026,CHN,SLE,1262645000,1337705000,1379860000,1411100000,4584067,6436698,7314773,8233970,0.01325207285096733,2.271079442844703
Jordan,Philippines,182,244,51,41,175,177,187,5,0.027472527472527472,-131,-2.5686274509803924,12,0.06857142857142857,10,0.05649717514124294,JOR,PHL,5056174,6931258,9494246,10928721,77958223,94636700,103031365,112190977,1.7110876926952385,0.16668007089375825
Pakistan,Mauritius,1,3,7,82,163,187,187,186,186,6,0.8571428571428571,24,0.147239263803681,0,0,PAK,MUS,154369924,194454498,210969298,227196741,1186873,1250400,1262879,1266014,0.08230751866286673,14.770768727675998
Vanuatu,Fiji,170,167,167,167,179,184,186,16,0.09411764705882353,-3,-0.017964071856287425,7,0.03910614525139665,2,0.010869565217391304,VUT,FJI,192074,245453,276438,311685,832509,905169,917200,920422,59.67563405361182,20.208121926681457
Afghanistan,Poland,219,187,160,151,147,139,184,-35,-0.1598173515981735,-59,-0.36875,37,0.25170068027210885,45,0.3237410071942446,AFG,POL,19542982,28189672,33753499,38972230,38258629,38042794,37986412,37899070,0.47213105331668215,0.4855000399745957
China,Bahamas,67,80,93,126,159,172,183,116,1.7313432835820894,26,0.27956989247311825,24,0.1509433962264151,11,0.06395348837209303,CHN,BHS,1262645000,1337705000,1379860000,1411100000,325014,373272,392697,406471,0.012968606052016158,45.02166206199212
China,Sint Maarten (Dutch part),0,0,0,83,167,174,183,183,1,0,0,16,0.09580838323353294,9,0.05172413793103448,CHN,SXM,1262645000,1337705000,1379860000,1411100000,30519,34056,38825,40350,0.012968606052016158,453.5315985130112
Malaysia,Cambodia,80,210,339,265,191,172,182,102,1.275,259,0.7640117994100295,-9,-0.04712041884816754,10,0.05813953488372093,MYS,KHM,22945150,28717731,31068833,33199993,12118841,14363532,15417523,16396860,0.5481928866671749,1.1099686159423205
Nepal,Jordan,9,115,220,166,343,141,182,173,19.22222222222222,211,0.9590909090909091,-161,-0.46938775510204084,41,0.2907801418439716,NPL,JOR,24559500,27161567,27610325,29348627,5056174,6931258,9494246,10928721,0.6201312245373523,1.6653366848691626
North Korea,Brazil,0,0,0,71,144,169,182,182,1,0,0,38,0.2638888888888889,13,0.07692307692307693,PRK,BRA,23367059,24686435,25258015,25867467,175873720,196353492,205188205,213196304,0.7035864779493098,0.08536733357253698
Sri Lanka,Philippines,43,57,151,122,170,172,182,139,3.2325581395348837,108,0.7152317880794702,12,0.07058823529411765,10,0.05813953488372093,LKA,PHL,18776371,20668557,21336697,21919000,77958223,94636700,103031365,112190977,0.8303298508143621,0.1622233845062246
Kuwait,Philippines,47,63,56,45,168,171,181,134,2.851063829787234,9,0.16071428571428573,13,0.07738095238095238,10,0.05847953216374269,KWT,PHL,1934901,2943356,3908743,4360444,77958223,94636700,103031365,112190977,4.150953435017168,0.16133204722871786
Philippines,Mongolia,31,33,37,82,138,170,181,150,4.838709677419355,6,0.16216216216216217,43,0.3115942028985507,11,0.06470588235294118,PHL,MNG,77958223,94636700,103031365,112190977,2450979,2702520,2964749,3294335,0.16133204722871786,5.4942803327530445
Philippines,Slovenia,3,5,6,17,63,114,181,178,59.333333333333336,3,0.5,118,1.873015873015873,67,0.5877192982456141,PHL,SVN,77958223,94636700,103031365,112190977,1988925,2048583,2063531,2102419,0.16133204722871786,8.609130720374958
Vanuatu,United Kingdom,16,67,121,130,136,161,181,165,10.3125,105,0.8677685950413223,45,0.33088235294117646,20,0.12422360248447205,VUT,GBR,192074,245453,276438,311685,58892514,62766365,65116219,67081234,58.07145034249322,0.26982210851994765
Thailand,Romania,0,0,0,0,0,12,178,178,1,0,0,178,1,166,13.833333333333334,THA,ROU,63066603,68270489,70294397,71475664,22442971,20246871,19815616,19265250,0.249035811685499,0.9239433695384177
Fiji,France,93,96,99,44,147,162,177,84,0.9032258064516129,6,0.06060606060606061,30,0.20408163265306123,15,0.09259259259259259,FJI,FRA,832509,905169,917200,920422,60921384,65030575,66548272,67571107,19.230309575390418,0.2619462783109355
India,Tonga,140,158,177,206,220,188,177,37,0.2642857142857143,37,0.20903954802259886,-43,-0.19545454545454546,-11,-0.05851063829787234,IND,TON,1059633675,1240613620,1322866505,1396387127,102603,107383,106122,105254,0.012675568012451321,168.1646303228381
Indonesia,Romania,0,0,0,0,0,13,177,177,1,0,0,177,1,164,12.615384615384615,IDN,ROU,214072421,244016173,259091970,271857970,22442971,20246871,19815616,19265250,0.06510752655145627,0.9187526764511231
Italy,Maldives,310,352,374,294,229,164,177,-133,-0.4290322580645161,64,0.1711229946524064,-52,-0.22707423580786026,13,0.07926829268292683,ITA,MDV,56942108,59277417,60730582,59438851,282507,361575,435582,514438,0.2977850295255539,34.40647852608089
Nepal,Seychelles,27,33,39,98,157,175,177,150,5.555555555555555,12,0.3076923076923077,20,0.12738853503184713,2,0.011428571428571429,NPL,SYC,24559500,27161567,27610325,29348627,81131,89770,93419,98462,0.6030946524346777,179.76478235258273
Afghanistan,Azerbaijan,254,223,224,213,195,186,176,-78,-0.30708661417322836,-30,-0.13392857142857142,-19,-0.09743589743589744,-10,-0.053763440860215055,AFG,AZE,19542982,28189672,33753499,38972230,8048600,9054332,9649341,10093121,0.45160361621595685,1.7437619146743608
Indonesia,Mexico,69,82,99,120,154,160,175,106,1.536231884057971,30,0.30303030303030304,21,0.13636363636363635,15,0.09375,IDN,MEX,214072421,244016173,259091970,271857970,97873442,112532401,120149897,125998302,0.06437184828533811,0.1388907606072342
Nepal,Russian Federation,573,492,395,285,171,175,173,-400,-0.6980802792321117,-178,-0.4506329113924051,2,0.011695906432748537,-2,-0.011428571428571429,NPL,RUS,24559500,27161567,27610325,29348627,146596869,142849468,144640716,145245148,0.5894653947525382,0.11910897016676936
Pakistan,Namibia,246,235,219,173,166,162,173,-73,-0.2967479674796748,-27,-0.1232876712328767,7,0.04216867469879518,11,0.06790123456790123,PAK,NAM,154369924,194454498,210969298,227196741,1819141,2099271,2282704,2489098,0.07614545844211736,6.950308907082003
Sri Lanka,Latvia,31,21,12,26,40,28,173,142,4.580645161290323,-19,-1.5833333333333333,133,3.325,145,5.178571428571429,LKA,LVA,18776371,20668557,21336697,21919000,2367550,2097555,1977527,1900449,0.7892695834663991,9.103111948807888
China,Mauritania,142,151,156,158,110,158,172,30,0.2112676056338028,14,0.08974358974358974,62,0.5636363636363636,14,0.08860759493670886,CHN,MRT,1262645000,1337705000,1379860000,1411100000,2695003,3419461,3946220,4498604,0.012189072354900432,3.8234083284503373
Pakistan,North Korea,72,90,107,131,154,170,172,100,1.3888888888888888,35,0.32710280373831774,18,0.11688311688311688,2,0.011764705882352941,PAK,PRK,154369924,194454498,210969298,227196741,23367059,24686435,25258015,25867467,0.0757053112834924,0.6649278802597873
Brazil,Philippines,123,165,4146,3355,160,162,171,48,0.3902439024390244,4023,0.9703328509406657,11,0.06875,9,0.05555555555555555,BRA,PHL,175873720,196353492,205188205,213196304,77958223,94636700,103031365,112190977,0.08020776945551551,0.15241867445365057
Thailand,Panama,3,3,4,57,123,144,171,168,56,1,0.25,48,0.3902439024390244,27,0.1875,THA,PAN,63066603,68270489,70294397,71475664,3001731,3623617,3957099,4294396,0.2392422685293277,3.9819336642452163
Egypt,Philippines,33,44,336,271,158,161,170,137,4.151515151515151,303,0.9017857142857143,12,0.0759493670886076,9,0.055900621118012424,EGY,PHL,71371371,87252413,97723799,107465134,77958223,94636700,103031365,112190977,0.1581908416919668,0.15152733717614386
Indonesia,Cyprus,43,61,79,118,181,165,169,126,2.9302325581395348,36,0.45569620253164556,-12,-0.06629834254143646,4,0.024242424242424242,IDN,CYP,214072421,244016173,259091970,271857970,948237,1129686,1187280,1237537,0.06216481348698367,13.65615735125495
Afghanistan,Ireland,29,79,173,173,145,148,168,139,4.793103448275862,144,0.8323699421965318,23,0.15862068965517243,20,0.13513513513513514,AFG,IRL,19542982,28189672,33753499,38972230,3805174,4560155,4701957,4985382,0.43107617911523155,3.369852099598386
Iran,Slovakia,11,198,93,206,104,130,168,157,14.272727272727273,82,0.8817204301075269,64,0.6153846153846154,38,0.2923076923076923,IRN,SVK,65544383,75373855,81790841,87290193,5388720,5391428,5423801,5458827,0.19246148304426366,3.077584250242772
Afghanistan,Ecuador,18,21,23,28,44,112,167,149,8.277777777777779,5,0.21739130434782608,123,2.7954545454545454,55,0.49107142857142855,AFG,ECU,19542982,28189672,33753499,38972230,12626507,14989585,16195902,17588595,0.4285102494776409,0.9494789094865167
Philippines,Costa Rica,72,71,106,70,138,139,167,95,1.3194444444444444,34,0.32075471698113206,29,0.21014492753623187,28,0.2014388489208633,PHL,CRI,77958223,94636700,103031365,112190977,3979193,4622252,4895242,5123105,0.14885332534362367,3.259741894807934
Bangladesh,Philippines,70,94,754,610,156,158,166,96,1.3714285714285714,684,0.9071618037135278,10,0.0641025641025641,8,0.05063291139240506,BGD,PHL,129193327,148391139,157830000,167420951,77958223,94636700,103031365,112190977,0.09915127050018967,0.14796198806611693
Hong Kong,North Korea,97,102,106,128,149,164,166,69,0.711340206185567,9,0.08490566037735849,17,0.11409395973154363,2,0.012195121951219513,HKG,PRK,6665000,7024200,7291300,7481000,23367059,24686435,25258015,25867467,2.218954685202513,0.6417327216460739
Iran,Iceland,14,16,18,27,35,63,166,152,10.857142857142858,4,0.2222222222222222,131,3.742857142857143,103,1.6349206349206349,IRN,ISL,65544383,75373855,81790841,87290193,281205,318041,330815,366463,0.1901702749127843,45.297888190622245
South Korea,Brunei Darussalam,138,141,144,147,150,153,165,27,0.1956521739130435,6,0.041666666666666664,15,0.1,12,0.0784313725490196,KOR,BRN,47008111,49554112,51014947,51836239,333926,396053,421437,441725,0.3183101304861257,37.35355707736714
Canada,Mongolia,26,28,32,74,125,154,164,138,5.3076923076923075,6,0.1875,39,0.312,10,0.06493506493506493,CAN,MNG,30685730,34005902,35704498,38028638,2450979,2702520,2964749,3294335,0.43125394078010365,4.978242953433698
Mongolia,Belarus,96,136,175,168,161,168,164,68,0.7083333333333334,79,0.4514285714285714,3,0.018633540372670808,-4,-0.023809523809523808,MNG,BLR,2450979,2702520,2964749,3294335,9979610,9483836,9461076,9379952,4.978242953433698,1.7484097999648611
North Korea,South Africa,137,85,58,76,110,141,163,26,0.1897810218978102,-79,-1.3620689655172413,53,0.4818181818181818,22,0.15602836879432624,PRK,ZAF,23367059,24686435,25258015,25867467,46813266,51784921,55876504,58801927,0.6301351423392171,0.27720179986618465
Pakistan,Mexico,23,53,87,110,145,150,163,140,6.086956521739131,64,0.735632183908046,18,0.12413793103448276,13,0.08666666666666667,PAK,MEX,154369924,194454498,210969298,227196741,97873442,112532401,120149897,125998302,0.07174398685586779,0.12936682273702388
Bhutan,France,240,248,255,44,81,149,162,-78,-0.325,15,0.058823529411764705,81,1,13,0.087248322147651,BTN,FRA,587207,705516,743274,772506,60921384,65030575,66548272,67571107,20.97071090709975,0.23974744116594096
Philippines,Cambodia,71,186,301,235,169,152,162,91,1.2816901408450705,230,0.7641196013289037,-7,-0.04142011834319527,10,0.06578947368421052,PHL,KHM,77958223,94636700,103031365,112190977,12118841,14363532,15417523,16396860,0.14439663895609,0.9879940427618459
Bangladesh,Romania,3,5,7,8,11,100,161,158,52.666666666666664,4,0.5714285714285714,150,13.636363636363637,61,0.61,BGD,ROU,129193327,148391139,157830000,167420951,22442971,20246871,19815616,19265250,0.09616478644897913,0.8357015870544114
China,Guinea,134,154,166,116,81,169,161,27,0.20149253731343283,32,0.1927710843373494,80,0.9876543209876543,-8,-0.047337278106508875,CHN,GIN,1262645000,1337705000,1379860000,1411100000,8336967,10270728,11625998,13205153,0.011409538657784707,1.2192210116762752
Greece,Philippines,19,25,245,198,150,153,161,142,7.473684210526316,226,0.9224489795918367,11,0.07333333333333333,8,0.05228758169934641,GRC,PHL,10805808,11121341,10820883,10698599,77958223,94636700,103031365,112190977,1.5048699367085354,0.1435053016785833
Indonesia,Panama,49,70,97,96,116,135,161,112,2.2857142857142856,48,0.4948453608247423,45,0.3879310344827586,26,0.1925925925925926,IDN,PAN,214072421,244016173,259091970,271857970,3001731,3623617,3957099,4294396,0.05922210042251106,3.7490720464530987
Indonesia,Russian Federation,377,336,283,223,160,163,161,-216,-0.5729442970822282,-94,-0.3321554770318021,1,0.00625,-2,-0.012269938650306749,IDN,RUS,214072421,244016173,259091970,271857970,146596869,142849468,144640716,145245148,0.05922210042251106,0.11084707628236917
Iran,Slovenia,8,17,30,31,54,89,161,153,19.125,22,0.7333333333333333,107,1.9814814814814814,72,0.8089887640449438,IRN,SVN,65544383,75373855,81790841,87290193,1988925,2048583,2063531,2102419,0.18444225458408597,7.657845557902588
North Korea,Peru,53,54,64,75,83,88,161,108,2.0377358490566038,11,0.171875,78,0.9397590361445783,73,0.8295454545454546,PRK,PER,23367059,24686435,25258015,25867467,26654439,29229572,30711863,33304756,0.6224034228013126,0.48341444086844537
Vietnam,Brazil,0,0,0,0,127,149,161,161,1,0,0,34,0.2677165354330709,12,0.08053691275167785,VNM,BRA,79001142,87411012,92191398,96648685,175873720,196353492,205188205,213196304,0.1665827113943661,0.07551725662185964
Indonesia,Iceland,59,67,75,93,108,129,158,99,1.6779661016949152,16,0.21333333333333335,50,0.46296296296296297,29,0.2248062015503876,IDN,ISL,214072421,244016173,259091970,271857970,281205,318041,330815,366463,0.05811858302333384,43.11485743444768
North Korea,Gabon,50,67,83,90,105,146,158,108,2.16,33,0.39759036144578314,53,0.5047619047619047,12,0.0821917808219178,PRK,GAB,23367059,24686435,25258015,25867467,1272935,1711105,2028517,2292573,0.6108058434944558,6.891819802466487
India,Papua New Guinea,239,244,182,182,154,156,156,-83,-0.3472803347280335,-57,-0.3131868131868132,2,0.012987012987012988,0,0,IND,PNG,1059633675,1240613620,1322866505,1396387127,5508297,7583269,8682174,9749640,0.011171687061821502,1.600059079104459
Malaysia,Hungary,0,40,79,98,117,93,156,156,1,79,1,39,0.3333333333333333,63,0.6774193548387096,MYS,HUN,22945150,28717731,31068833,33199993,10210971,10000023,9843028,9750149,0.46987961714329274,1.5999755490916088
Argentina,Philippines,32,43,657,531,146,148,155,123,3.84375,625,0.9512937595129376,9,0.06164383561643835,7,0.0472972972972973,ARG,PHL,37070774,40788453,43131966,45376763,77958223,94636700,103031365,112190977,0.34158452422002866,0.13815727801354294
Philippines,Bulgaria,10,15,20,27,33,72,155,145,14.5,10,0.5,122,3.696969696969697,83,1.1527777777777777,PHL,BGR,77958223,94636700,103031365,112190977,8170172,7395599,7177991,6934015,0.13815727801354294,2.235357148780324
Malaysia,Brazil,0,0,0,0,121,142,154,154,1,0,0,33,0.2727272727272727,12,0.08450704225352113,MYS,BRA,22945150,28717731,31068833,33199993,175873720,196353492,205188205,213196304,0.46385551948760956,0.07223389763830051
Mongolia,Norway,0,0,8,42,94,146,154,154,1,8,1,60,0.6382978723404256,8,0.0547945205479452,MNG,NOR,2450979,2702520,2964749,3294335,4490967,4889252,5188607,5379475,4.674691553834082,2.8627328875029625
Nepal,Ireland,26,73,159,159,133,136,154,128,4.923076923076923,133,0.8364779874213837,21,0.15789473684210525,18,0.1323529411764706,NPL,IRL,24559500,27161567,27610325,29348627,3805174,4560155,4701957,4985382,0.524726420762375,3.08903109129852
North Korea,Tajikistan,238,193,166,159,158,155,154,-84,-0.35294117647058826,-72,-0.43373493975903615,-4,-0.02531645569620253,-1,-0.0064516129032258064,PRK,TJK,23367059,24686435,25258015,25867467,6272998,7621779,8524063,9543207,0.5953424044186467,1.613713293654848
Sri Lanka,North Korea,120,126,132,136,139,153,154,34,0.2833333333333333,12,0.09090909090909091,15,0.1079136690647482,1,0.006535947712418301,LKA,PRK,18776371,20668557,21336697,21919000,23367059,24686435,25258015,25867467,0.7025867968429217,0.5953424044186467
Bangladesh,North Korea,74,86,97,118,138,152,153,79,1.0675675675675675,23,0.23711340206185566,15,0.10869565217391304,1,0.006578947368421052,BGD,PRK,129193327,148391139,157830000,167420951,23367059,24686435,25258015,25867467,0.0913864119670423,0.5914765446496946
North Korea,Spain,17,27,334,161,103,115,153,136,8,317,0.9491017964071856,50,0.4854368932038835,38,0.33043478260869563,PRK,ESP,23367059,24686435,25258015,25867467,40567864,46576897,46444832,47365655,0.5914765446496946,0.32301886250702116
Thailand,Greenland,3,12,35,62,126,157,153,150,50,32,0.9142857142857143,27,0.21428571428571427,-4,-0.025477707006369428,THA,GRL,63066603,68270489,70294397,71475664,56200,56905,56114,56367,0.21405887184203004,271.4354143381766
Mexico,Philippines,31,41,105,84,143,145,152,121,3.903225806451613,74,0.7047619047619048,9,0.06293706293706294,7,0.04827586206896552,MEX,PHL,97873442,112532401,120149897,125998302,77958223,94636700,103031365,112190977,0.12063654635599773,0.13548326618102274
South Korea,Poland,53,44,38,78,122,115,152,99,1.8679245283018868,-15,-0.39473684210526316,30,0.2459016393442623,37,0.3217391304347826,KOR,POL,47008111,49554112,51014947,51836239,38258629,38042794,37986412,37899070,0.29323115050843096,0.40106525041379637
Iran,Egypt,134,118,111,132,142,97,150,16,0.11940298507462686,-23,-0.2072072072072072,8,0.056338028169014086,53,0.5463917525773195,IRN,EGY,65544383,75373855,81790841,87290193,71371371,87252413,97723799,107465134,0.17184060986094968,0.13958015443408836
Nepal,South Africa,125,77,53,70,101,130,150,25,0.2,-72,-1.3584905660377358,49,0.48514851485148514,20,0.15384615384615385,NPL,ZAF,24559500,27161567,27610325,29348627,46813266,51784921,55876504,58801927,0.5110971630802355,0.25509368085845213
Philippines,Venezuela (Bolivarian Republic of),143,141,138,144,153,161,150,7,0.04895104895104895,-5,-0.036231884057971016,-3,-0.0196078431372549,-11,-0.06832298136645963,PHL,VEN,77958223,94636700,103031365,112190977,24427729,28715022,30529716,28490453,0.13370059162600928,0.5264921551089412
Russian Federation,Sri Lanka,1,18,36,72,147,148,150,149,149,35,0.9722222222222222,3,0.02040816326530612,2,0.013513513513513514,RUS,LKA,146596869,142849468,144640716,145245148,18776371,20668557,21336697,21919000,0.10327367355500235,0.6843377891327159
Hong Kong,Portugal,27,57,91,112,116,132,149,122,4.518518518518518,64,0.7032967032967034,33,0.28448275862068967,17,0.12878787878787878,HKG,PRT,6665000,7024200,7291300,7481000,10289898,10573100,10358076,10297081,1.9917123379227377,1.4470120221449168
Timor-Leste,Philippines,7,9,1717,1389,139,141,149,142,20.285714285714285,1710,0.9959231217239372,10,0.07194244604316546,8,0.05673758865248227,TLS,PHL,878360,1088486,1205813,1299995,77958223,94636700,103031365,112190977,11.461582544548248,0.13280925434850255
North Korea,Ireland,25,70,153,153,128,131,148,123,4.92,128,0.8366013071895425,20,0.15625,17,0.1297709923664122,PRK,IRL,23367059,24686435,25258015,25867467,3805174,4560155,4701957,4985382,0.5721472458049333,2.968679230598578
Indonesia,Poland,62,53,46,80,117,110,146,84,1.3548387096774193,-16,-0.34782608695652173,29,0.24786324786324787,36,0.32727272727272727,IDN,POL,214072421,244016173,259091970,271857970,38258629,38042794,37986412,37899070,0.05370451342662494,0.3852337273711466
Myanmar,Czechia,1,1,1,30,56,130,146,145,145,0,0,90,1.6071428571428572,16,0.12307692307692308,MMR,CZE,45538332,49390988,51483949,53423198,10255063,10474410,10546059,10697858,0.27328951741151847,1.3647591882412349
Russian Federation,North Korea,43,58,72,102,132,145,146,103,2.395348837209302,29,0.4027777777777778,14,0.10606060606060606,1,0.006896551724137931,RUS,PRK,146596869,142849468,144640716,145245148,23367059,24686435,25258015,25867467,0.10051970892686893,0.5644155262670287
South Korea,Portugal,21,46,73,101,113,129,146,125,5.9523809523809526,52,0.7123287671232876,33,0.2920353982300885,17,0.13178294573643412,KOR,PRT,47008111,49554112,51014947,51836239,10289898,10573100,10358076,10297081,0.2816562366725719,1.4178775519003881
Indonesia,Ireland,24,67,148,149,125,128,145,121,5.041666666666667,124,0.8378378378378378,20,0.16,17,0.1328125,IDN,IRL,214072421,244016173,259091970,271857970,3805174,4560155,4701957,4985382,0.05333667429356587,2.908503300248607
Nepal,Estonia,0,0,0,0,20,41,145,145,1,0,0,125,6.25,104,2.5365853658536586,NPL,EST,24559500,27161567,27610325,29348627,1396985,1331475,1315407,1329522,0.49406059097756094,10.906175302101056
Philippines,Russian Federation,190,175,154,150,144,147,145,-45,-0.23684210526315788,-36,-0.23376623376623376,1,0.006944444444444444,-2,-0.013605442176870748,PHL,RUS,77958223,94636700,103031365,112190977,146596869,142849468,144640716,145245148,0.12924390523847565,0.09983121776983558
China,Nicaragua,55,44,81,121,129,139,144,89,1.6181818181818182,26,0.32098765432098764,15,0.11627906976744186,5,0.03597122302158273,CHN,NIC,1262645000,1337705000,1379860000,1411100000,5123222,5855734,6298598,6755895,0.010204804762242224,2.1314718479194834
Armenia,Philippines,31,41,141,114,133,135,143,112,3.6129032258064515,110,0.7801418439716312,10,0.07518796992481203,8,0.05925925925925926,ARM,PHL,3168523,2946293,2878595,2805608,77958223,94636700,103031365,112190977,5.096934425621826,0.12746123068346218
Indonesia,Seychelles,2,114,226,176,126,141,143,141,70.5,224,0.9911504424778761,17,0.1349206349206349,2,0.014184397163120567,IDN,SYC,214072421,244016173,259091970,271857970,81131,89770,93419,98462,0.052600996027447715,145.23369421705834
South Korea,Uganda,59,55,160,154,154,154,143,84,1.423728813559322,101,0.63125,-11,-0.07142857142857142,-11,-0.07142857142857142,KOR,UGA,47008111,49554112,51014947,51836239,24020697,32341728,37477356,44404611,0.2758687797546423,0.3220386279253747
Bangladesh,Luxembourg,29,27,26,22,20,30,142,113,3.896551724137931,-3,-0.11538461538461539,122,6.1,112,3.7333333333333334,BGD,LUX,129193327,148391139,157830000,167420951,436300,506953,569604,630419,0.0848161470543791,22.52470182529397
Lebanon,Philippines,30,40,140,113,131,134,142,112,3.7333333333333334,110,0.7857142857142857,11,0.08396946564885496,8,0.05970149253731343,LBN,PHL,4320642,4995800,6398940,5662923,77958223,94636700,103031365,112190977,2.5075389511741553,0.12656989340595545
United States of America,Bhutan,63,74,85,107,129,136,141,78,1.2380952380952381,22,0.25882352941176473,12,0.09302325581395349,5,0.03676470588235294,USA,BTN,282162411,309327143,320738994,331526933,587207,705516,743274,772506,0.042530481226392546,18.25228541914238
Cabo Verde,Philippines,12,16,11,8,128,131,139,127,10.583333333333334,-1,-0.09090909090909091,11,0.0859375,8,0.061068702290076333,CPV,PHL,458251,521212,552166,582640,77958223,94636700,103031365,112190977,23.85692709048469,0.12389588157343527
China,Antigua and Barbuda,57,84,110,118,126,134,139,82,1.4385964912280702,53,0.4818181818181818,13,0.10317460317460317,5,0.03731343283582089,CHN,ATG,1262645000,1337705000,1379860000,1411100000,75055,85695,89941,92664,0.009850471263553257,150.00431667098334
Thailand,Faroe Islands,5,10,17,47,72,112,138,133,26.6,12,0.7058823529411765,66,0.9166666666666666,26,0.23214285714285715,THA,FRO,63066603,68270489,70294397,71475664,45660,48410,48816,52415,0.1930727079359487,263.28341123724124
Iran,Argentina,302,295,288,214,137,137,137,-165,-0.5463576158940397,-14,-0.04861111111111111,0,0,0,0,IRN,ARG,65544383,75373855,81790841,87290193,37070774,40788453,43131966,45376763,0.15694775700633404,0.3019166439880253
Somalia,Thailand,2,9,19,68,122,130,136,134,67,17,0.8947368421052632,14,0.11475409836065574,6,0.046153846153846156,SOM,THA,8721465,12026649,13763906,16537016,63066603,68270489,70294397,71475664,0.8223974627586984,0.19027455274847116
Laos,Austria,69,78,86,95,105,120,134,65,0.9420289855072463,17,0.19767441860465115,29,0.2761904761904762,14,0.11666666666666667,LAO,AUT,5430853,6323418,6787419,7319399,8011566,8363404,8642699,8916864,1.830751404589366,1.5027704807430056
Myanmar,Austria,39,44,49,54,59,95,134,95,2.4358974358974357,10,0.20408163265306123,75,1.271186440677966,39,0.4105263157894737,MMR,AUT,45538332,49390988,51483949,53423198,8011566,8363404,8642699,8916864,0.2508273652955033,1.5027704807430056
Pakistan,Peru,44,45,53,62,69,73,134,90,2.0454545454545454,9,0.16981132075471697,65,0.9420289855072463,61,0.8356164383561644,PAK,PER,154369924,194454498,210969298,227196741,26654439,29229572,30711863,33304756,0.05897971925574408,0.40234493836255697
Sri Lanka,Nauru,0,0,0,0,216,39,134,134,1,0,0,-82,-0.37962962962962965,95,2.4358974358974357,LKA,NRU,18776371,20668557,21336697,21919000,10377,10241,11185,12315,0.6113417582918929,1088.1039382866422
Malaysia,Vietnam,13,33,79,90,106,128,133,120,9.23076923076923,66,0.8354430379746836,27,0.25471698113207547,5,0.0390625,MYS,VNM,22945150,28717731,31068833,33199993,79001142,87411012,92191398,96648685,0.40060249410293547,0.13761180506491114
Afghanistan,Sri Lanka,0,15,31,63,129,131,132,132,1,31,1,3,0.023255813953488372,1,0.007633587786259542,AFG,LKA,19542982,28189672,33753499,38972230,18776371,20668557,21336697,21919000,0.3387027121619677,0.6022172544367901
Japan,Bhutan,59,69,80,100,120,127,132,73,1.2372881355932204,21,0.2625,12,0.1,5,0.03937007874015748,JPN,BTN,126843000,128070000,127141000,126261000,587207,705516,743274,772506,0.10454534654406349,17.087245924303502
Japan,Cambodia,58,152,246,192,138,125,132,74,1.2758620689655173,188,0.7642276422764228,-6,-0.043478260869565216,7,0.056,JPN,KHM,126843000,128070000,127141000,126261000,12118841,14363532,15417523,16396860,0.10454534654406349,0.8050321829911338
Thailand,Mexico,35,48,64,86,118,123,132,97,2.7714285714285714,29,0.453125,14,0.11864406779661017,9,0.07317073170731707,THA,MEX,63066603,68270489,70294397,71475664,97873442,112532401,120149897,125998302,0.18467824237351613,0.10476331657231382
Colombia,Philippines,156,209,56,45,123,125,131,-25,-0.16025641025641027,-100,-1.7857142857142858,8,0.06504065040650407,6,0.048,COL,PHL,39215135,44816108,47119728,50930662,77958223,94636700,103031365,112190977,0.2572124430662221,0.11676518335338144
Egypt,Sri Lanka,1,15,31,63,128,130,131,130,130,30,0.967741935483871,3,0.0234375,1,0.007692307692307693,EGY,LKA,71371371,87252413,97723799,107465134,18776371,20668557,21336697,21919000,0.12190000153910382,0.5976550025092385
Suriname,Philippines,28,37,131,106,123,125,131,103,3.6785714285714284,103,0.7862595419847328,8,0.06504065040650407,6,0.048,SUR,PHL,478998,546080,575475,607065,77958223,94636700,103031365,112190977,21.579237808142455,0.11676518335338144
Laos,Norway,56,64,50,53,84,99,130,74,1.3214285714285714,-6,-0.12,46,0.5476190476190477,31,0.31313131313131315,LAO,NOR,5430853,6323418,6787419,7319399,4490967,4889252,5188607,5379475,1.776102108929982,2.4165926972427605
Papua New Guinea,Netherlands,0,0,0,131,135,128,130,130,1,0,0,-5,-0.037037037037037035,2,0.015625,PNG,NLD,5508297,7583269,8682174,9749640,15925513,16615394,16939923,17441500,1.3333825659203828,0.7453487372072356
Philippines,Ecuador,42,47,52,62,99,125,130,88,2.0952380952380953,10,0.19230769230769232,31,0.31313131313131315,5,0.04,PHL,ECU,77958223,94636700,103031365,112190977,12626507,14989585,16195902,17588595,0.11587384607587471,0.7391153187619591
Singapore,Cambodia,57,150,242,189,136,123,130,73,1.280701754385965,185,0.7644628099173554,-6,-0.04411764705882353,7,0.056910569105691054,SGP,KHM,4027887,5076732,5535002,5685807,12118841,14363532,15417523,16396860,2.286394877631267,0.7928347256730862
Sweden,Sri Lanka,29,39,51,76,127,129,130,101,3.4827586206896552,22,0.43137254901960786,3,0.023622047244094488,1,0.007751937984496124,SWE,LKA,8872109,9378126,9799186,10353442,18776371,20668557,21336697,21919000,1.2556210775121934,0.5930927505816871
Turkey,India,343,236,129,141,151,140,130,-213,-0.6209912536443148,-214,-1.6589147286821706,-21,-0.1390728476821192,-10,-0.07142857142857142,TUR,IND,64113547,73142150,78218479,83384680,1059633675,1240613620,1322866505,1396387127,0.15590393822942056,0.009309739218184586
Hong Kong,Curaçao,0,0,0,0,104,111,129,129,1,0,0,25,0.2403846153846154,18,0.16216216216216217,HKG,CUW,6665000,7024200,7291300,7481000,133860,148703,157980,154947,1.7243683999465311,83.25427404209181
Nepal,Iceland,8,12,15,56,94,98,129,121,15.125,7,0.4666666666666667,35,0.3723404255319149,31,0.3163265306122449,NPL,ISL,24559500,27161567,27610325,29348627,281205,318041,330815,366463,0.43954356024900243,35.20137094331488
South Korea,El Salvador,208,161,114,119,123,128,129,-79,-0.3798076923076923,-94,-0.8245614035087719,6,0.04878048780487805,1,0.0078125,KOR,SLV,47008111,49554112,51014947,51836239,5958482,6114034,6231066,6292731,0.24886064747097106,2.0499843390731307
Bangladesh,Poland,60,51,44,72,103,97,128,68,1.1333333333333333,-16,-0.36363636363636365,25,0.24271844660194175,31,0.31958762886597936,BGD,POL,129193327,148391139,157830000,167420951,38258629,38042794,37986412,37899070,0.07645399171098963,0.337739158243197
Switzerland,Maldives,102,100,92,84,101,118,128,26,0.2549019607843137,-10,-0.10869565217391304,27,0.26732673267326734,10,0.0847457627118644,CHE,MDV,7184250,7824909,8282396,8638167,282507,361575,435582,514438,1.4817958485868588,24.881521194002
Philippines,Greenland,1,5,6,9,50,130,127,126,126,5,0.8333333333333334,77,1.54,-3,-0.023076923076923078,PHL,GRL,77958223,94636700,103031365,112190977,56200,56905,56114,56367,0.11319983424335452,225.3091347774407
Philippines,Micronesia (Fed. States of),170,154,143,133,128,125,127,-43,-0.2529411764705882,-27,-0.1888111888111888,-1,-0.0078125,2,0.016,PHL,FSM,77958223,94636700,103031365,112190977,111709,107588,109462,112106,0.11319983424335452,113.28564037607265
Thailand,Poland,53,44,38,68,102,96,127,74,1.3962264150943395,-15,-0.39473684210526316,25,0.24509803921568626,31,0.3229166666666667,THA,POL,63066603,68270489,70294397,71475664,38258629,38042794,37986412,37899070,0.17768285440482232,0.335100571069422
Cambodia,Dominican Republic,118,131,144,130,116,121,126,8,0.06779661016949153,26,0.18055555555555555,10,0.08620689655172414,5,0.04132231404958678,KHM,DOM,12118841,14363532,15417523,16396860,8540791,9775755,10405832,10999664,0.7684398110369912,1.1454895349530678
Qatar,Philippines,27,36,126,101,119,120,126,99,3.6666666666666665,99,0.7857142857142857,7,0.058823529411764705,6,0.05,QAT,PHL,645937,1713504,2414573,2760385,77958223,94636700,103031365,112190977,4.564580665378199,0.1123084969658478
Cambodia,Spain,5,8,103,50,82,95,125,120,24,98,0.9514563106796117,43,0.524390243902439,30,0.3157894736842105,KHM,ESP,12118841,14363532,15417523,16396860,40567864,46576897,46444832,47365655,0.7623410823779675,0.2639042994338408
France,Maldives,51,70,86,81,98,115,124,73,1.4313725490196079,35,0.4069767441860465,26,0.2653061224489796,9,0.0782608695652174,FRA,MDV,60921384,65030575,66548272,67571107,282507,361575,435582,514438,0.18351038706528813,24.103973656689437
Nepal,Northern Mariana Islands,156,191,239,221,140,125,124,-32,-0.20512820512820512,83,0.3472803347280335,-16,-0.11428571428571428,-1,-0.008,NPL,MNP,24559500,27161567,27610325,29348627,80338,54087,51514,49587,0.4225069881463279,250.0655413717305
Australia,Cambodia,54,142,229,179,129,116,123,69,1.2777777777777777,175,0.7641921397379913,-6,-0.046511627906976744,7,0.0603448275862069,AUS,KHM,19028802,22031750,23815995,25649248,12118841,14363532,15417523,16396860,0.47954622295359306,0.75014362505992
Hong Kong,Cambodia,54,142,229,179,129,116,123,69,1.2777777777777777,175,0.7641921397379913,-6,-0.046511627906976744,7,0.0603448275862069,HKG,KHM,6665000,7024200,7291300,7481000,12118841,14363532,15417523,16396860,1.6441652185536693,0.75014362505992
Albania,Philippines,421,566,582,471,114,116,122,-299,-0.7102137767220903,161,0.2766323024054983,8,0.07017543859649122,6,0.05172413793103448,ALB,PHL,3089027,2913021,2880703,2837849,77958223,94636700,103031365,112190977,4.2990307095268285,0.10874314785582088
Pakistan,Slovakia,2,25,93,125,69,90,122,120,60,91,0.978494623655914,53,0.7681159420289855,32,0.35555555555555557,PAK,SVK,154369924,194454498,210969298,227196741,5388720,5391428,5423801,5458827,0.05369795335224461,2.234912372200108
Solomon Islands,Vanuatu,83,65,51,75,113,120,122,39,0.46987951807228917,-32,-0.6274509803921569,9,0.07964601769911504,2,0.016666666666666666,SLB,VUT,429978,540394,612660,691191,192074,245453,276438,311685,17.650692789692,39.142082551293775
Indonesia,Luxembourg,0,0,0,0,0,0,121,121,1,0,0,121,1,121,1,IDN,LUX,214072421,244016173,259091970,271857970,436300,506953,569604,630419,0.044508535100148065,19.193583949722328
Iran,Georgia,0,0,120,113,114,119,121,121,1,120,1,7,0.06140350877192982,2,0.01680672268907563,IRN,GEO,65544383,75373855,81790841,87290193,4077131,3786695,3725276,3722716,0.1386180919544994,3.2503150925292177
North Korea,Uganda,51,48,136,131,131,131,121,70,1.3725490196078431,85,0.625,-10,-0.07633587786259542,-10,-0.07633587786259542,PRK,UGA,23367059,24686435,25258015,25867467,24020697,32341728,37477356,44404611,0.46776903204322245,0.2724942236291632
Pakistan,Cayman Islands,34,66,114,103,102,110,121,87,2.5588235294117645,80,0.7017543859649122,19,0.18627450980392157,11,0.1,PAK,CYM,154369924,194454498,210969298,227196741,39658,54074,60911,67311,0.05325780619361965,179.76259452392625
Laos,Russian Federation,100,85,68,94,119,122,120,20,0.2,-32,-0.47058823529411764,1,0.008403361344537815,-2,-0.01639344262295082,LAO,RUS,5430853,6323418,6787419,7319399,146596869,142849468,144640716,145245148,1.6394788697815217,0.08261893884400187
Iran,Costa Rica,81,63,77,51,100,100,119,38,0.4691358024691358,-4,-0.05194805194805195,19,0.19,19,0.19,IRN,CRI,65544383,75373855,81790841,87290193,3979193,4622252,4895242,5123105,0.13632688382302008,2.32281009270745
Finland,Philippines,9,12,430,348,110,112,118,109,12.11111111111111,421,0.9790697674418605,8,0.07272727272727272,6,0.05357142857142857,FIN,PHL,5176209,5363352,5479531,5529543,77958223,94636700,103031365,112190977,2.1339919049368095,0.10517779874579396
India,Bolivia (Plurinational State of),125,123,119,106,92,108,118,-7,-0.056,-6,-0.05042016806722689,26,0.2826086956521739,10,0.09259259259259259,IND,BOL,1059633675,1240613620,1322866505,1396387127,8592656,10223270,11090085,11936162,0.008450378674967547,0.9885924805645232
Japan,Maldives,65,76,83,86,97,109,118,53,0.8153846153846154,18,0.21686746987951808,21,0.21649484536082475,9,0.08256880733944955,JPN,MDV,126843000,128070000,127141000,126261000,282507,361575,435582,514438,0.09345720372878402,22.937652350720594
Philippines,Vietnam,12,29,70,80,94,113,118,106,8.833333333333334,58,0.8285714285714286,24,0.2553191489361702,5,0.04424778761061947,PHL,VNM,77958223,94636700,103031365,112190977,79001142,87411012,92191398,96648685,0.10517779874579396,0.12209167667413168
Bahrain,Philippines,19,25,8381,6783,110,111,117,98,5.157894736842105,8362,0.9977329674263214,7,0.06363636363636363,6,0.05405405405405406,BHR,PHL,711442,1213645,1362142,1477469,77958223,94636700,103031365,112190977,7.918947876402145,0.10428646146828724
Bangladesh,Uganda,49,46,131,126,133,126,117,68,1.3877551020408163,82,0.6259541984732825,-16,-0.12030075187969924,-9,-0.07142857142857142,BGD,UGA,129193327,148391139,157830000,167420951,24020697,32341728,37477356,44404611,0.06988372679832645,0.2634861501207611
China,Eritrea,8,53,98,102,112,135,117,109,13.625,90,0.9183673469387755,5,0.044642857142857144,-18,-0.13333333333333333,CHN,ERI,1262645000,1337705000,1379860000,1411100000,2392880,3147727,3340006,3555868,0.008291403869321805,3.2903358617361502
Fiji,Marshall Islands,43,56,67,86,111,118,117,74,1.7209302325581395,24,0.3582089552238806,6,0.05405405405405406,-1,-0.00847457627118644,FJI,MHL,832509,905169,917200,920422,54224,53416,49410,43413,12.711560566783497,269.5045262939672
India,Mongolia,24,26,29,56,90,111,117,93,3.875,5,0.1724137931034483,27,0.3,6,0.05405405405405406,IND,MNG,1059633675,1240613620,1322866505,1396387127,2450979,2702520,2964749,3294335,0.008378765296366128,3.5515513753155035
Myanmar,Panama,23,32,44,58,85,98,117,94,4.086956521739131,21,0.4772727272727273,32,0.3764705882352941,19,0.19387755102040816,MMR,PAN,45538332,49390988,51483949,53423198,3001731,3623617,3957099,4294396,0.21900598313114839,2.7244809281677798
Norway,Sri Lanka,1,14,28,57,116,117,117,116,116,27,0.9642857142857143,1,0.008620689655172414,0,0,NOR,LKA,4490967,4889252,5188607,5379475,18776371,20668557,21336697,21919000,2.1749334275184844,0.5337834755235183
Peru,Philippines,6,8,512,414,110,111,117,111,18.5,506,0.98828125,7,0.06363636363636363,6,0.05405405405405406,PER,PHL,26654439,29229572,30711863,33304756,77958223,94636700,103031365,112190977,0.35130117752551615,0.10428646146828724
Myanmar,Spain,7,12,145,70,76,87,116,109,15.571428571428571,138,0.9517241379310345,40,0.5263157894736842,29,0.3333333333333333,MMR,ESP,45538332,49390988,51483949,53423198,40567864,46576897,46444832,47365655,0.21713413712148044,0.2449031898746043
Philippines,Solomon Islands,147,146,140,130,129,120,116,-31,-0.2108843537414966,-7,-0.05,-13,-0.10077519379844961,-4,-0.03333333333333333,PHL,SLB,77958223,94636700,103031365,112190977,429978,540394,612660,691191,0.10339512419078051,16.78262593118255
Poland,Philippines,12,16,75,60,108,110,116,104,8.666666666666666,63,0.84,8,0.07407407407407407,6,0.05454545454545454,POL,PHL,38258629,38042794,37986412,37899070,77958223,94636700,103031365,112190977,0.30607611215789726,0.10339512419078051
Malaysia,Malta,16,19,24,29,32,54,115,99,6.1875,8,0.3333333333333333,83,2.59375,61,1.1296296296296295,MYS,MLT,22945150,28717731,31068833,33199993,390087,414508,445053,515332,0.34638561520178635,22.31571103676853
United Kingdom,Vanuatu,239,152,95,100,107,113,115,-124,-0.5188284518828452,-144,-1.5157894736842106,8,0.07476635514018691,2,0.017699115044247787,GBR,VUT,58892514,62766365,65116219,67081234,192074,245453,276438,311685,0.1714339363524529,36.896225355727736
China,Tonga,91,103,115,134,143,122,114,23,0.25274725274725274,24,0.20869565217391303,-29,-0.20279720279720279,-8,-0.06557377049180328,CHN,TON,1262645000,1337705000,1379860000,1411100000,102603,107383,106122,105254,0.008078803770108426,108.30942291979403
China,Liechtenstein,28,40,52,58,66,81,113,85,3.0357142857142856,24,0.46153846153846156,47,0.7121212121212122,32,0.3950617283950617,CHN,LIE,1262645000,1337705000,1379860000,1411100000,33026,35926,37355,38756,0.008007937070370633,291.5677572504903
Nepal,Hungary,0,19,38,47,56,52,113,113,1,38,1,57,1.0178571428571428,61,1.1730769230769231,NPL,HUN,24559500,27161567,27610325,29348627,10210971,10000023,9843028,9750149,0.385026529520444,1.1589566477394346
North Korea,Austria,1550,1749,1947,2158,2397,118,113,-1437,-0.9270967741935484,397,0.20390344119157677,-2284,-0.952857738840217,-5,-0.0423728813559322,PRK,AUT,23367059,24686435,25258015,25867467,8011566,8363404,8642699,8916864,0.43684215389160447,1.2672616740594003
Portugal,Hong Kong,73,82,90,98,107,109,113,40,0.547945205479452,17,0.18888888888888888,6,0.056074766355140186,4,0.03669724770642202,PRT,HKG,10289898,10573100,10358076,10297081,6665000,7024200,7291300,7481000,1.0973983792105744,1.510493249565566
Cambodia,Russian Federation,227,190,148,131,112,114,112,-115,-0.5066079295154186,-79,-0.5337837837837838,0,0,-2,-0.017543859649122806,KHM,RUS,12118841,14363532,15417523,16396860,146596869,142849468,144640716,145245148,0.6830576098106589,0.07711100958773508
Afghanistan,South Africa,59,36,30,52,75,96,111,52,0.8813559322033898,-29,-0.9666666666666667,36,0.48,15,0.15625,AFG,ZAF,19542982,28189672,33753499,38972230,46813266,51784921,55876504,58801927,0.2848181897725637,0.18876932383525458
Indonesia,Cambodia,49,129,208,162,116,105,111,62,1.2653061224489797,159,0.7644230769230769,-5,-0.04310344827586207,6,0.05714285714285714,IDN,KHM,214072421,244016173,259091970,271857970,12118841,14363532,15417523,16396860,0.04083014376955732,0.676958881151635
Malaysia,Luxembourg,26,24,23,19,17,25,111,85,3.269230769230769,-3,-0.13043478260869565,94,5.529411764705882,86,3.44,MYS,LUX,22945150,28717731,31068833,33199993,436300,506953,569604,630419,0.3343374198904199,17.607337342307257
New Zealand,Sri Lanka,1,13,27,54,110,111,111,110,110,26,0.9629629629629629,1,0.00909090909090909,0,0,NZL,LKA,3857700,4350700,4609400,5090200,18776371,20668557,21336697,21919000,2.180660877765117,0.5064099639582098
Sri Lanka,Poland,35,30,26,56,89,83,111,76,2.1714285714285713,-9,-0.34615384615384615,22,0.24719101123595505,28,0.3373493975903614,LKA,POL,18776371,20668557,21336697,21919000,38258629,38042794,37986412,37899070,0.5064099639582098,0.2928831762890224
Fiji,Samoa,68,120,173,162,142,118,110,42,0.6176470588235294,105,0.6069364161849711,-32,-0.22535211267605634,-8,-0.06779661016949153,FJI,WSM,832509,905169,917200,920422,184008,194672,203571,214929,11.95103984911269,51.179691898254774
United Kingdom,Maldives,94,94,89,101,102,103,110,16,0.1702127659574468,-5,-0.056179775280898875,8,0.0784313725490196,7,0.06796116504854369,GBR,MDV,58892514,62766365,65116219,67081234,282507,361575,435582,514438,0.1639802869458245,21.382557276095465
Thailand,Estonia,0,0,0,0,15,44,109,109,1,0,0,94,6.266666666666667,65,1.4772727272727273,THA,EST,63066603,68270489,70294397,71475664,1396985,1331475,1315407,1329522,0.15249945771752466,8.198435227096656
Afghanistan,Iceland,1,1,1,4,6,13,108,107,107,0,0,102,17,95,7.3076923076923075,AFG,ISL,19542982,28189672,33753499,38972230,281205,318041,330815,366463,0.2771204008597917,29.470915208356644
Malaysia,Maldives,46,53,58,60,80,101,108,62,1.3478260869565217,12,0.20689655172413793,28,0.35,7,0.06930693069306931,MYS,MDV,22945150,28717731,31068833,33199993,282507,361575,435582,514438,0.325301273406895,20.993783507439186
Iran,Peru,34,35,42,50,55,59,107,73,2.1470588235294117,8,0.19047619047619047,52,0.9454545454545454,48,0.8135593220338984,IRN,PER,65544383,75373855,81790841,87290193,26654439,29229572,30711863,33304756,0.1225796350341441,0.3212754358566686
Thailand,Slovakia,1,18,40,45,50,71,107,106,106,39,0.975,57,1.14,36,0.5070422535211268,THA,SVK,63066603,68270489,70294397,71475664,5388720,5391428,5423801,5458827,0.14970130253004715,1.960128064142718
Philippines,Estonia,0,0,0,0,17,56,106,106,1,0,0,89,5.235294117647059,50,0.8928571428571429,PHL,EST,77958223,94636700,103031365,112190977,1396985,1331475,1315407,1329522,0.09448175141571323,7.972790220846289
Fiji,Nauru,221,204,188,176,58,91,105,-116,-0.5248868778280543,-33,-0.17553191489361702,47,0.8103448275862069,14,0.15384615384615385,FJI,NRU,832509,905169,917200,920422,10377,10241,11185,12315,11.407810765062113,852.6187576126675
Malaysia,Solomon Islands,133,132,126,117,116,108,105,-28,-0.21052631578947367,-7,-0.05555555555555555,-11,-0.09482758620689655,-3,-0.027777777777777776,MYS,SLB,22945150,28717731,31068833,33199993,429978,540394,612660,691191,0.31626512692337017,15.191170023915243
United Kingdom,Mongolia,65,71,79,75,80,99,105,40,0.6153846153846154,14,0.17721518987341772,25,0.3125,6,0.06060606060606061,GBR,MNG,58892514,62766365,65116219,67081234,2450979,2702520,2964749,3294335,0.15652663753919613,3.187289695795965
Iran,Sri Lanka,1,12,25,51,103,104,104,103,103,24,0.96,1,0.009708737864077669,0,0,IRN,LKA,65544383,75373855,81790841,87290193,18776371,20668557,21336697,21919000,0.11914282283692511,0.4744742004653497
Laos,Hungary,40,35,30,38,45,46,104,64,1.6,-10,-0.3333333333333333,59,1.3111111111111111,58,1.2608695652173914,LAO,HUN,5430853,6323418,6787419,7319399,10210971,10000023,9843028,9750149,1.4208816871439856,1.0666503660610724
North Korea,Namibia,149,142,133,105,101,98,104,-45,-0.30201342281879195,-16,-0.12030075187969924,3,0.0297029702970297,6,0.061224489795918366,PRK,NAM,23367059,24686435,25258015,25867467,1819141,2099271,2282704,2489098,0.40204941597103416,4.17822038344814
India,Eritrea,39,54,70,83,99,119,103,64,1.641025641025641,31,0.44285714285714284,4,0.04040404040404041,-16,-0.13445378151260504,IND,ERI,1059633675,1240613620,1322866505,1396387127,2392880,3147727,3340006,3555868,0.007376177995946249,2.8966204594771234
Mongolia,Latvia,87,133,180,155,128,109,103,16,0.1839080459770115,93,0.5166666666666667,-25,-0.1953125,-6,-0.05504587155963303,MNG,LVA,2450979,2702520,2964749,3294335,2367550,2097555,1977527,1900449,3.126579415876042,5.419771853914523
Pakistan,Tajikistan,178,144,125,108,107,105,103,-75,-0.42134831460674155,-53,-0.424,-4,-0.037383177570093455,-2,-0.01904761904761905,PAK,TJK,154369924,194454498,210969298,227196741,6272998,7621779,8524063,9543207,0.04533515733837045,1.0793017483535672
Thailand,Jordan,73,100,126,95,195,81,103,30,0.410958904109589,53,0.42063492063492064,-92,-0.4717948717948718,22,0.2716049382716049,THA,JOR,63066603,68270489,70294397,71475664,5056174,6931258,9494246,10928721,0.14410499215509212,0.9424707612171634
North Korea,Egypt,117,93,76,90,97,66,102,-15,-0.1282051282051282,-41,-0.5394736842105263,5,0.05154639175257732,36,0.5454545454545454,PRK,EGY,23367059,24686435,25258015,25867467,71371371,87252413,97723799,107465134,0.3943176964331297,0.09491450501518009
Vietnam,Kyrgyzstan,372,278,178,150,122,107,102,-270,-0.7258064516129032,-194,-1.0898876404494382,-20,-0.16393442622950818,-5,-0.04672897196261682,VNM,KGZ,79001142,87411012,92191398,96648685,4898400,5447900,5956900,6579900,0.10553687305730027,1.5501755345825925
Canada,Maldives,12,46,78,66,80,94,101,89,7.416666666666667,66,0.8461538461538461,21,0.2625,7,0.07446808510638298,CAN,MDV,30685730,34005902,35704498,38028638,282507,361575,435582,514438,0.2655893171877468,19.633075317142204
Hong Kong,Ecuador,33,37,41,49,77,97,101,68,2.0606060606060606,8,0.1951219512195122,24,0.3116883116883117,4,0.041237113402061855,HKG,ECU,6665000,7024200,7291300,7481000,12626507,14989585,16195902,17588595,1.3500868867798423,0.574235747653522
India,Cambodia,44,116,187,146,105,95,101,57,1.2954545454545454,143,0.7647058823529411,-4,-0.0380952380952381,6,0.06315789473684211,IND,KHM,1059633675,1240613620,1322866505,1396387127,12118841,14363532,15417523,16396860,0.007232951238743409,0.6159715945613977
Mongolia,Bulgaria,23,29,35,45,54,79,101,78,3.391304347826087,12,0.34285714285714286,47,0.8703703703703703,22,0.27848101265822783,MNG,BGR,2450979,2702520,2964749,3294335,8170172,7395599,7177991,6934015,3.0658691359561185,1.4565875614633081
Fiji,Solomon Islands,220,218,208,154,110,103,100,-120,-0.5454545454545454,-12,-0.057692307692307696,-10,-0.09090909090909091,-3,-0.02912621359223301,FJI,SLB,832509,905169,917200,920422,429978,540394,612660,691191,10.864581681011536,14.467780975157371
Iran,Panama,31,45,62,61,74,86,99,68,2.193548387096774,31,0.5,25,0.33783783783783783,13,0.1511627906976744,IRN,PAN,65544383,75373855,81790841,87290193,3001731,3623617,3957099,4294396,0.11341480250822678,2.3053300161419674
Pakistan,Panama,43,45,51,55,72,84,99,56,1.302325581395349,8,0.1568627450980392,27,0.375,15,0.17857142857142858,PAK,PAN,154369924,194454498,210969298,227196741,3001731,3623617,3957099,4294396,0.04357456870387062,2.3053300161419674
Philippines,Latvia,1,1,2,3,5,108,99,98,98,1,0.5,94,18.8,-9,-0.08333333333333333,PHL,LVA,77958223,94636700,103031365,112190977,2367550,2097555,1977527,1900449,0.08824239047316612,5.209295277063473
South Korea,Estonia,0,0,0,0,19,69,99,99,1,0,0,80,4.2105263157894735,30,0.43478260869565216,KOR,EST,47008111,49554112,51014947,51836239,1396985,1331475,1315407,1329522,0.19098607829167544,7.4462852062621
Vanuatu,Papua New Guinea,152,155,116,116,98,99,98,-54,-0.35526315789473684,-36,-0.3103448275862069,0,0,-1,-0.010101010101010102,VUT,PNG,192074,245453,276438,311685,5508297,7583269,8682174,9749640,31.44200073792451,1.0051653189245962
Chile,Philippines,9,12,108,87,92,93,97,88,9.777777777777779,99,0.9166666666666666,5,0.05434782608695652,4,0.043010752688172046,CHL,PHL,15351799,17004162,17870124,19300315,77958223,94636700,103031365,112190977,0.502582470804233,0.08645971591815267
India,Argentina,215,210,205,152,97,97,97,-118,-0.5488372093023256,-10,-0.04878048780487805,0,0,0,0,IND,ARG,1059633675,1240613620,1322866505,1396387127,37070774,40788453,43131966,45376763,0.006946497724337729,0.21376579902801793
India,Dominican Republic,287,319,351,221,91,94,97,-190,-0.662020905923345,64,0.18233618233618235,6,0.06593406593406594,3,0.031914893617021274,IND,DOM,1059633675,1240613620,1322866505,1396387127,8540791,9775755,10405832,10999664,0.006946497724337729,0.8818451181781553
United Kingdom,Cambodia,43,113,182,142,102,92,97,54,1.255813953488372,139,0.7637362637362637,-5,-0.049019607843137254,5,0.05434782608695652,GBR,KHM,58892514,62766365,65116219,67081234,12118841,14363532,15417523,16396860,0.1446007984885907,0.5915766799253028
Fiji,Switzerland,133,90,49,53,66,81,96,-37,-0.2781954887218045,-84,-1.7142857142857142,30,0.45454545454545453,15,0.18518518518518517,FJI,CHE,832509,905169,917200,920422,7184250,7824909,8282396,8638167,10.429998413771076,1.1113468864401441
Myanmar,Greece,42,31,21,21,20,24,95,53,1.2619047619047619,-21,-1,75,3.75,71,2.9583333333333335,MMR,GRC,45538332,49390988,51483949,53423198,10805808,11121341,10820883,10698599,0.1778253709184538,0.8879667328404401
Indonesia,Namibia,133,127,120,94,90,88,94,-39,-0.2932330827067669,-13,-0.10833333333333334,4,0.044444444444444446,6,0.06818181818181818,IDN,NAM,214072421,244016173,259091970,271857970,1819141,2099271,2282704,2489098,0.03457687850755305,3.776468423501204
North Korea,Belgium,1679,1674,1623,1086,73,131,94,-1585,-0.9440142942227516,-56,-0.03450400492914356,21,0.2876712328767123,-37,-0.2824427480916031,PRK,BEL,23367059,24686435,25258015,25867467,10251250,10895586,11274196,11538604,0.36339081828151165,0.8146566083730753
Pakistan,Iceland,8,10,12,20,26,38,94,86,10.75,4,0.3333333333333333,68,2.6153846153846154,56,1.4736842105263157,PAK,ISL,154369924,194454498,210969298,227196741,281205,318041,330815,366463,0.041373832910745846,25.650611385051153
Iran,Jordan,119,117,115,87,179,73,93,-26,-0.2184873949579832,-4,-0.034782608695652174,-86,-0.48044692737430167,20,0.273972602739726,IRN,JOR,65544383,75373855,81790841,87290193,5056174,6931258,9494246,10928721,0.1065411781137888,0.8509687455650117
North Korea,Netherlands,2,2,4,27,31,121,93,91,45.5,2,0.5,62,2,-28,-0.23140495867768596,PRK,NLD,23367059,24686435,25258015,25867467,15925513,16615394,16939923,17441500,0.35952495851255944,0.533211019694407
South Korea,Jordan,96,106,115,87,179,73,93,-3,-0.03125,19,0.16521739130434782,-86,-0.48044692737430167,20,0.273972602739726,KOR,JOR,47008111,49554112,51014947,51836239,5056174,6931258,9494246,10928721,0.1794111644558163,0.8509687455650117
China,New Caledonia,77,89,101,107,114,87,91,14,0.18181818181818182,24,0.2376237623762376,-23,-0.20175438596491227,4,0.04597701149425287,CHN,NCL,1262645000,1337705000,1379860000,1411100000,213230,249750,269460,271080,0.006448869676139182,33.56942599970488
Vietnam,Mexico,81,64,50,62,82,84,91,10,0.12345679012345678,-31,-0.62,9,0.10975609756097561,7,0.08333333333333333,VNM,MEX,79001142,87411012,92191398,96648685,97873442,112532401,120149897,125998302,0.09415544557072866,0.0722231955157618
Russian Federation,Hong Kong,59,66,72,79,86,87,90,31,0.5254237288135594,13,0.18055555555555555,4,0.046511627906976744,3,0.034482758620689655,RUS,HKG,146596869,142849468,144640716,145245148,6665000,7024200,7291300,7481000,0.061964204133001397,1.2030477208929287
Bhutan,Switzerland,58,56,56,58,75,72,89,31,0.5344827586206896,-2,-0.03571428571428571,14,0.18666666666666668,17,0.2361111111111111,BTN,CHE,587207,705516,743274,772506,7184250,7824909,8282396,8638167,11.520946115628874,1.03031117597055
Greece,Sri Lanka,1,11,22,44,89,90,89,88,88,21,0.9545454545454546,0,0,-1,-0.011111111111111112,GRC,LKA,10805808,11121341,10820883,10698599,18776371,20668557,21336697,21919000,0.831884623397886,0.4060404215520781
Cambodia,Hungary,65,58,51,63,74,53,88,23,0.35384615384615387,-14,-0.27450980392156865,14,0.1891891891891892,35,0.660377358490566,KHM,HUN,12118841,14363532,15417523,16396860,10210971,10000023,9843028,9750149,0.5366881219940891,0.9025503097439844
Maldives,Switzerland,31,38,46,50,62,67,88,57,1.8387096774193548,15,0.32608695652173914,26,0.41935483870967744,21,0.31343283582089554,MDV,CHE,282507,361575,435582,514438,7184250,7824909,8282396,8638167,17.106045820876375,1.0187346459034654
China,Papua New Guinea,135,138,103,103,87,88,87,-48,-0.35555555555555557,-32,-0.3106796116504854,0,0,-1,-0.011363636363636364,CHN,PNG,1262645000,1337705000,1379860000,1411100000,5508297,7583269,8682174,9749640,0.006165402877188009,0.8923406402697945
Iran,Malta,9,11,13,17,24,41,87,78,8.666666666666666,4,0.3076923076923077,63,2.625,46,1.1219512195121952,IRN,MLT,65544383,75373855,81790841,87290193,390087,414508,445053,515332,0.09966755371935081,16.882320523468366
France,Mongolia,11,12,14,37,66,81,86,75,6.818181818181818,3,0.21428571428571427,20,0.30303030303030304,5,0.06172839506172839,FRA,MNG,60921384,65030575,66548272,67571107,2450979,2702520,2964749,3294335,0.1272733329646353,2.610542036556695
North Korea,Sweden,44,52,56,74,87,80,86,42,0.9545454545454546,12,0.21428571428571427,-1,-0.011494252873563218,6,0.075,PRK,SWE,23367059,24686435,25258015,25867467,8872109,9378126,9799186,10353442,0.33246394012989366,0.8306416358926819
Pakistan,Georgia,0,0,86,81,81,85,86,86,1,86,1,5,0.06172839506172839,1,0.011764705882352941,PAK,GEO,154369924,194454498,210969298,227196741,4077131,3786695,3725276,3722716,0.0378526556417462,2.3101413054339894
Pakistan,Sierra Leone,0,0,0,122,107,94,86,86,1,0,0,-21,-0.19626168224299065,-8,-0.0851063829787234,PAK,SLE,154369924,194454498,210969298,227196741,4584067,6436698,7314773,8233970,0.0378526556417462,1.0444536475114679
Sri Lanka,Portugal,3,7,12,19,23,26,86,83,27.666666666666668,9,0.75,63,2.739130434782609,60,2.3076923076923075,LKA,PRT,18776371,20668557,21336697,21919000,10289898,10573100,10358076,10297081,0.39235366576942377,0.8351881470098177
Thailand,Liechtenstein,0,1,2,40,79,88,86,86,1,2,1,7,0.08860759493670886,-2,-0.022727272727272728,THA,LIE,63066603,68270489,70294397,71475664,33026,35926,37355,38756,0.12032067306153323,221.90112498709874
Brunei Darussalam,Philippines,106,142,805,651,80,82,85,-21,-0.19811320754716982,699,0.8683229813664596,5,0.0625,3,0.036585365853658534,BRN,PHL,333926,396053,421437,441725,77958223,94636700,103031365,112190977,19.242741524704282,0.07576366858807193
Sri Lanka,Luxembourg,0,0,0,0,0,0,85,85,1,0,0,85,1,85,1,LKA,LUX,18776371,20668557,21336697,21919000,436300,506953,569604,630419,0.3877914138418723,13.483096163028081
Australia,Maldives,37,43,48,56,67,78,84,47,1.2702702702702702,11,0.22916666666666666,17,0.2537313432835821,6,0.07692307692307693,AUS,MDV,19028802,22031750,23815995,25649248,282507,361575,435582,514438,0.327494981529283,16.32849828356381
Iran,Venezuela (Bolivarian Republic of),201,154,118,105,98,90,84,-117,-0.582089552238806,-83,-0.7033898305084746,-14,-0.14285714285714285,-6,-0.06666666666666667,IRN,VEN,65544383,75373855,81790841,87290193,24427729,28715022,30529716,28490453,0.09623074152213183,0.29483560686100707
Iraq,Thailand,0,16,36,54,76,81,84,84,1,36,1,8,0.10526315789473684,3,0.037037037037037035,IRQ,THA,24628858,31264875,37757813,42556984,63066603,68270489,70294397,71475664,0.1973824084902257,0.11752251787405571
Fiji,Papua New Guinea,128,131,98,98,83,84,83,-45,-0.3515625,-30,-0.30612244897959184,0,0,-1,-0.011904761904761904,FJI,PNG,832509,905169,917200,920422,5508297,7583269,8682174,9749640,9.017602795239576,0.8513134843953213
North Korea,Jordan,40,71,102,77,159,65,83,43,1.075,62,0.6078431372549019,-76,-0.4779874213836478,18,0.27692307692307694,PRK,JOR,23367059,24686435,25258015,25867467,5056174,6931258,9494246,10928721,0.32086636082303693,0.7594667299128599
Vietnam,Latvia,3,5,7,8,10,7,83,80,26.666666666666668,4,0.5714285714285714,73,7.3,76,10.857142857142858,VNM,LVA,79001142,87411012,92191398,96648685,2367550,2097555,1977527,1900449,0.08587804376231295,4.367388969659276
North Korea,Italy,1,21,40,83,102,110,82,81,81,39,0.975,-20,-0.19607843137254902,-28,-0.2545454545454545,PRK,ITA,23367059,24686435,25258015,25867467,56942108,59277417,60730582,59438851,0.31700050105408467,0.13795690633387245
North Korea,Portugal,1,2,5,38,65,73,82,81,81,4,0.8,17,0.26153846153846155,9,0.1232876712328767,PRK,PRT,23367059,24686435,25258015,25867467,10289898,10573100,10358076,10297081,0.31700050105408467,0.7963421866837795
Singapore,Maldives,42,49,54,55,66,77,82,40,0.9523809523809523,12,0.2222222222222222,16,0.24242424242424243,5,0.06493506493506493,SGP,MDV,4027887,5076732,5535002,5685807,282507,361575,435582,514438,1.4421875381981837,15.93972451490753
Sri Lanka,Vietnam,46,114,278,151,101,79,82,36,0.782608695652174,232,0.8345323741007195,-19,-0.18811881188118812,3,0.0379746835443038,LKA,VNM,18776371,20668557,21336697,21919000,79001142,87411012,92191398,96648685,0.37410465805921805,0.084843368536261
India,Antigua and Barbuda,32,49,65,70,74,79,81,49,1.53125,33,0.5076923076923077,7,0.0945945945945946,2,0.02531645569620253,IND,ATG,1059633675,1240613620,1322866505,1396387127,75055,85695,89941,92664,0.005800683666715011,87.41258741258741
Pakistan,Dominican Republic,166,185,203,139,76,79,81,-85,-0.5120481927710844,37,0.18226600985221675,5,0.06578947368421052,2,0.02531645569620253,PAK,DOM,154369924,194454498,210969298,227196741,8540791,9775755,10405832,10999664,0.03565191984862142,0.7363861296126863
Malaysia,Peru,26,27,32,38,42,44,80,54,2.076923076923077,6,0.1875,38,0.9047619047619048,36,0.8181818181818182,MYS,PER,22945150,28717731,31068833,33199993,26654439,29229572,30711863,33304756,0.24096390622732963,0.2402059333507803
Angola,Philippines,581,781,2523,2042,74,76,79,-502,-0.8640275387263339,1942,0.7697185889813714,5,0.06756756756756757,3,0.039473684210526314,AGO,PHL,16394062,23364185,28127721,33428486,77958223,94636700,103031365,112190977,0.23632539026745036,0.07041564492303155
Singapore,Timor-Leste,57,62,68,73,75,81,79,22,0.38596491228070173,11,0.16176470588235295,4,0.05333333333333334,-2,-0.024691358024691357,SGP,TLS,4027887,5076732,5535002,5685807,878360,1088486,1205813,1299995,1.389424579483616,6.076946449794038
Hong Kong,Belize,47,49,50,56,61,71,78,31,0.6595744680851063,3,0.06,17,0.2786885245901639,7,0.09859154929577464,HKG,BLZ,6665000,7024200,7291300,7481000,240406,322106,359871,394921,1.042641358107205,19.750785600158007
Malaysia,Papua New Guinea,115,117,87,93,78,79,78,-37,-0.3217391304347826,-28,-0.3218390804597701,0,0,-1,-0.012658227848101266,MYS,PNG,22945150,28717731,31068833,33199993,5508297,7583269,8682174,9749640,0.23493980857164637,0.8000295395522296
Sri Lanka,Papua New Guinea,118,120,89,93,78,79,78,-40,-0.3389830508474576,-29,-0.3258426966292135,0,0,-1,-0.012658227848101266,LKA,PNG,18776371,20668557,21336697,21919000,5508297,7583269,8682174,9749640,0.3558556503490123,0.8000295395522296
Fiji,Netherlands,6,8,12,73,62,67,77,71,11.833333333333334,6,0.5,15,0.24193548387096775,10,0.14925373134328357,FJI,NLD,832509,905169,917200,920422,15925513,16615394,16939923,17441500,8.365727894378884,0.4414757904996703
Indonesia,Peru,25,26,31,37,41,43,77,52,2.08,6,0.1935483870967742,36,0.8780487804878049,34,0.7906976744186046,IDN,PER,214072421,244016173,259091970,271857970,26654439,29229572,30711863,33304756,0.028323613245548773,0.23119821085012604
Timor-Leste,Italy,10,27,44,62,69,99,77,67,6.7,34,0.7727272727272727,8,0.11594202898550725,-22,-0.2222222222222222,TLS,ITA,878360,1088486,1205813,1299995,56942108,59277417,60730582,59438851,5.923099704229632,0.12954489985009973
Hong Kong,Turkey,14,33,54,56,57,55,76,62,4.428571428571429,40,0.7407407407407407,19,0.3333333333333333,21,0.38181818181818183,HKG,TUR,6665000,7024200,7291300,7481000,64113547,73142150,78218479,83384680,1.0159069643095842,0.09114384081104587
Pakistan,Ghana,47,47,52,73,55,67,76,29,0.6170212765957447,5,0.09615384615384616,21,0.38181818181818183,9,0.13432835820895522,PAK,GHA,154369924,194454498,210969298,227196741,19665502,25574719,28870939,32180401,0.033451184055496644,0.23616859218130934
Papua New Guinea,Austria,33,37,41,45,50,79,76,43,1.303030303030303,8,0.1951219512195122,26,0.52,-3,-0.0379746835443038,PNG,AUT,5508297,7583269,8682174,9749640,8011566,8363404,8642699,8916864,0.779515961614993,0.852317586093048
Thailand,Namibia,109,104,98,77,74,72,76,-33,-0.30275229357798167,-11,-0.11224489795918367,2,0.02702702702702703,4,0.05555555555555555,THA,NAM,63066603,68270489,70294397,71475664,1819141,2099271,2282704,2489098,0.10632989712414563,3.0533148955967184
Iraq,Philippines,18,24,24,19,70,71,75,57,3.1666666666666665,6,0.25,5,0.07142857142857142,4,0.056338028169014086,IRQ,PHL,24628858,31264875,37757813,42556984,77958223,94636700,103031365,112190977,0.17623429329484439,0.06685029581300464
China,Georgia,421,337,74,70,70,73,74,-347,-0.8242280285035629,-347,-4.6891891891891895,4,0.05714285714285714,1,0.0136986301369863,CHN,GEO,1262645000,1337705000,1379860000,1411100000,4077131,3786695,3725276,3722716,0.005244135780596697,1.9877960070013398
South Korea,Mauritania,63,67,69,70,49,69,74,11,0.1746031746031746,6,0.08695652173913043,25,0.5102040816326531,5,0.07246376811594203,KOR,MRT,47008111,49554112,51014947,51836239,2695003,3419461,3946220,4498604,0.14275727064226246,1.6449547459611915
Sri Lanka,Hungary,47,42,36,44,52,61,74,27,0.574468085106383,-11,-0.3055555555555556,22,0.4230769230769231,13,0.21311475409836064,LKA,HUN,18776371,20668557,21336697,21919000,10210971,10000023,9843028,9750149,0.3376066426388065,0.7589627604665324
Afghanistan,Brazil,0,0,0,28,58,68,73,73,1,0,0,15,0.25862068965517243,5,0.07352941176470588,AFG,BRA,19542982,28189672,33753499,38972230,175873720,196353492,205188205,213196304,0.18731286354411847,0.034240743685687906
Solomon Islands,Nauru,39,36,33,31,41,64,73,34,0.8717948717948718,-6,-0.18181818181818182,32,0.7804878048780488,9,0.140625,SLB,NRU,429978,540394,612660,691191,10377,10241,11185,12315,10.561480111864883,592.7730410069021
India,Faroe Islands,14,24,38,56,58,63,72,58,4.142857142857143,24,0.631578947368421,14,0.2413793103448276,9,0.14285714285714285,IND,FRO,1059633675,1240613620,1322866505,1396387127,45660,48410,48816,52415,0.0051561632593022325,137.36525803682153
Myanmar,Ireland,12,35,76,76,63,64,72,60,5,64,0.8421052631578947,9,0.14285714285714285,8,0.125,MMR,IRL,45538332,49390988,51483949,53423198,3805174,4560155,4701957,4985382,0.13477291269609132,1.4442223283993083
Nepal,Philippines,74,99,616,498,67,68,72,-2,-0.02702702702702703,542,0.8798701298701299,5,0.07462686567164178,4,0.058823529411764705,NPL,PHL,24559500,27161567,27610325,29348627,77958223,94636700,103031365,112190977,0.24532663827851298,0.06417628398048446
Syrian Arab Republic,Sri Lanka,0,8,17,35,73,73,72,72,1,17,1,-1,-0.0136986301369863,-1,-0.0136986301369863,SYR,LKA,16307654,22337563,19205178,20772595,18776371,20668557,21336697,21919000,0.34661052218078675,0.32848213878370364
Laos,Denmark,18,21,24,38,49,66,71,53,2.9444444444444446,6,0.25,22,0.4489795918367347,5,0.07575757575757576,LAO,DNK,5430853,6323418,6787419,7319399,5339616,5547683,5683483,5831404,0.970024997954067,1.2175455516373073
Nepal,Poland,13,10,9,32,58,54,71,58,4.461538461538462,-4,-0.4444444444444444,13,0.22413793103448276,17,0.3148148148148148,NPL,POL,24559500,27161567,27610325,29348627,38258629,38042794,37986412,37899070,0.24191932385797807,0.18733968933802334
New Zealand,Solomon Islands,141,140,134,103,79,73,71,-70,-0.49645390070921985,-7,-0.05223880597014925,-8,-0.10126582278481013,-2,-0.0273972602739726,NZL,SLB,3857700,4350700,4609400,5090200,429978,540394,612660,691191,1.3948371380299398,10.272124492361735
Philippines,Guatemala,15,28,41,50,58,64,71,56,3.7333333333333334,26,0.6341463414634146,13,0.22413793103448276,7,0.109375,PHL,GTM,77958223,94636700,103031365,112190977,11589761,14259687,15567419,16858333,0.06328494670297773,0.42115670630067636
Russian Federation,Philippines,23,30,80,64,65,67,71,48,2.0869565217391304,57,0.7125,6,0.09230769230769231,4,0.05970149253731343,RUS,PHL,146596869,142849468,144640716,145245148,77958223,94636700,103031365,112190977,0.04888287214936777,0.06328494670297773
New Zealand,Timor-Leste,139,151,165,175,179,72,70,-69,-0.49640287769784175,26,0.15757575757575756,-109,-0.6089385474860335,-2,-0.027777777777777776,NZL,TLS,3857700,4350700,4609400,5090200,878360,1088486,1205813,1299995,1.3751915445365603,5.38463609475421
Sri Lanka,Turkey,18,21,36,38,68,51,70,52,2.888888888888889,18,0.5,2,0.029411764705882353,19,0.37254901960784315,LKA,TUR,18776371,20668557,21336697,21919000,64113547,73142150,78218479,83384680,0.31935763492860075,0.08394827443122646
Vanuatu,Greece,3,4,5,39,75,70,70,67,22.333333333333332,2,0.4,-5,-0.06666666666666667,0,0,VUT,GRC,192074,245453,276438,311685,10805808,11121341,10820883,10698599,22.45857195566036,0.6542912768297979
Cambodia,Luxembourg,0,0,0,0,0,0,69,69,1,0,0,69,1,69,1,KHM,LUX,12118841,14363532,15417523,16396860,436300,506953,569604,630419,0.4208122774726381,10.945101591163972
Fiji,Sweden,28,33,36,44,54,59,69,41,1.4642857142857142,8,0.2222222222222222,15,0.2777777777777778,10,0.1694915254237288,FJI,SWE,832509,905169,917200,920422,8872109,9378126,9799186,10353442,7.496561359897959,0.6664450334487796
Philippines,Croatia,0,0,0,38,75,75,69,69,1,0,0,-6,-0.08,-6,-0.08,PHL,HRV,77958223,94636700,103031365,112190977,4468302,4295427,4203604,4047680,0.06150227214796426,1.7046802118744566
South Korea,Honduras,53,53,52,51,49,68,69,16,0.3018867924528302,-1,-0.019230769230769232,20,0.40816326530612246,1,0.014705882352941176,KOR,HND,47008111,49554112,51014947,51836239,6656725,8450933,9294505,10121763,0.13311150911237984,0.681699423311927
Vietnam,Panama,5,6,8,27,51,59,69,64,12.8,3,0.375,18,0.35294117647058826,10,0.1694915254237288,VNM,PAN,79001142,87411012,92191398,96648685,3001731,3623617,3957099,4294396,0.07139259059758547,1.6067451627656135
Indonesia,Slovenia,2,4,8,14,25,43,68,66,33,6,0.75,43,1.72,25,0.5813953488372093,IDN,SVN,214072421,244016173,259091970,271857970,1988925,2048583,2063531,2102419,0.025013061048017093,3.234369552406062
Iran,Bolivia (Plurinational State of),21,29,36,45,53,63,68,47,2.238095238095238,15,0.4166666666666667,15,0.2830188679245283,5,0.07936507936507936,IRN,BOL,65544383,75373855,81790841,87290193,8592656,10223270,11090085,11936162,0.07790107647029719,0.5696973616812506
Papua New Guinea,South Africa,59,36,25,32,46,59,68,9,0.15254237288135594,-34,-1.36,22,0.4782608695652174,9,0.15254237288135594,PNG,ZAF,5508297,7583269,8682174,9749640,46813266,51784921,55876504,58801927,0.6974616498660463,0.11564246865583162
Papua New Guinea,Vanuatu,50,50,50,56,63,67,68,18,0.36,0,0,5,0.07936507936507936,1,0.014925373134328358,PNG,VUT,5508297,7583269,8682174,9749640,192074,245453,276438,311685,0.6974616498660463,21.816898471212923
South Korea,Palau,11,19,141,80,76,68,68,57,5.181818181818182,130,0.9219858156028369,-8,-0.10526315789473684,0,0,KOR,PLW,47008111,49554112,51014947,51836239,19726,18540,17794,17972,0.13118235680640333,378.36634765190297
Bangladesh,Timor-Leste,103,112,122,130,133,69,67,-36,-0.34951456310679613,19,0.1557377049180328,-66,-0.49624060150375937,-2,-0.028985507246376812,BGD,TLS,129193327,148391139,157830000,167420951,878360,1088486,1205813,1299995,0.04001888628622113,5.153865976407602
Indonesia,Solomon Islands,85,85,81,75,74,69,67,-18,-0.21176470588235294,-4,-0.04938271604938271,-7,-0.0945945945945946,-2,-0.028985507246376812,IDN,SLB,214072421,244016173,259091970,271857970,429978,540394,612660,691191,0.024645221914958017,9.693413253355441
Malaysia,Romania,0,0,0,0,0,1,67,67,1,0,0,67,1,66,66,MYS,ROU,22945150,28717731,31068833,33199993,22442971,20246871,19815616,19265250,0.20180727146538854,0.3477764368487302
Maldives,South Africa,54,34,24,31,45,58,67,13,0.24074074074074073,-30,-1.25,22,0.4888888888888889,9,0.15517241379310345,MDV,ZAF,282507,361575,435582,514438,46813266,51784921,55876504,58801927,13.02392124998542,0.11394184411677528
Mongolia,Republic of Moldova,348,235,159,110,83,69,67,-281,-0.8074712643678161,-189,-1.1886792452830188,-16,-0.1927710843373494,-2,-0.028985507246376812,MNG,MDA,2450979,2702520,2964749,3294335,2924668,2862354,2835978,2635130,2.033794377317425,2.5425690573140605
North Korea,France,99,102,105,80,56,63,67,-32,-0.32323232323232326,6,0.05714285714285714,11,0.19642857142857142,4,0.06349206349206349,PRK,FRA,23367059,24686435,25258015,25867467,60921384,65030575,66548272,67571107,0.25901260451980085,0.09915480591430889
Indonesia,Ecuador,22,25,27,33,51,64,66,44,2,5,0.18518518518518517,15,0.29411764705882354,2,0.03125,IDN,ECU,214072421,244016173,259091970,271857970,12626507,14989585,16195902,17588595,0.024277382781898945,0.3752431618329946
Mongolia,Denmark,2,10,17,41,62,63,66,64,32,15,0.8823529411764706,4,0.06451612903225806,3,0.047619047619047616,MNG,DNK,2450979,2702520,2964749,3294335,5339616,5547683,5683483,5831404,2.0034392373574637,1.1318029071558067
Mongolia,Slovakia,11,22,41,47,52,64,66,55,5,30,0.7317073170731707,14,0.2692307692307692,2,0.03125,MNG,SVK,2450979,2702520,2964749,3294335,5388720,5391428,5423801,5458827,2.0034392373574637,1.2090509554525175
Nepal,Greece,29,21,14,33,53,49,66,37,1.2758620689655173,-15,-1.0714285714285714,13,0.24528301886792453,17,0.3469387755102041,NPL,GRC,24559500,27161567,27610325,29348627,10805808,11121341,10820883,10698599,0.22488275175530356,0.6169032038680953
Afghanistan,Estonia,0,0,0,0,13,26,65,65,1,0,0,52,4,39,1.5,AFG,EST,19542982,28189672,33753499,38972230,1396985,1331475,1315407,1329522,0.16678542644339317,4.888975135424611
Aruba,Philippines,9,12,67,54,62,63,65,56,6.222222222222222,58,0.8656716417910447,3,0.04838709677419355,2,0.031746031746031744,ABW,PHL,89101,100341,104257,106585,77958223,94636700,103031365,112190977,60.984191021250645,0.057936923037937356
Iran,Serbia,7,50,68,68,67,65,65,58,8.285714285714286,61,0.8970588235294118,-2,-0.029850746268656716,0,0,IRN,SRB,65544383,75373855,81790841,87290193,7516346,7291436,7095383,6899126,0.07446426427307819,0.9421483242949904
Philippines,Nauru,100,92,85,79,36,57,65,-35,-0.35,-15,-0.17647058823529413,29,0.8055555555555556,8,0.14035087719298245,PHL,NRU,77958223,94636700,103031365,112190977,10377,10241,11185,12315,0.057936923037937356,527.8116118554608
Thailand,Venezuela (Bolivarian Republic of),62,61,60,62,66,70,65,3,0.04838709677419355,-2,-0.03333333333333333,-1,-0.015151515151515152,-5,-0.07142857142857142,THA,VEN,63066603,68270489,70294397,71475664,24427729,28715022,30529716,28490453,0.0909400435930193,0.22814660054720784
Brazil,Timor-Leste,152,165,181,192,197,66,64,-88,-0.5789473684210527,29,0.16022099447513813,-133,-0.6751269035532995,-2,-0.030303030303030304,BRA,TLS,175873720,196353492,205188205,213196304,878360,1088486,1205813,1299995,0.030019282135397618,4.923095858060992
India,Costa Rica,35,31,42,28,55,54,64,29,0.8285714285714286,7,0.16666666666666666,9,0.16363636363636364,10,0.18518518518518517,IND,CRI,1059633675,1240613620,1322866505,1396387127,3979193,4622252,4895242,5123105,0.004583256230490873,1.2492424028006452
Sudan,Philippines,17,22,23,18,61,62,64,47,2.764705882352941,6,0.2608695652173913,3,0.04918032786885246,2,0.03225806451612903,SDN,PHL,26298773,33739933,38171178,44440486,77958223,94636700,103031365,112190977,0.14401282650239244,0.05704558576043063
Syrian Arab Republic,Philippines,19,25,26,21,61,62,64,45,2.3684210526315788,7,0.2692307692307692,3,0.04918032786885246,2,0.03225806451612903,SYR,PHL,16307654,22337563,19205178,20772595,77958223,94636700,103031365,112190977,0.3080982419384771,0.05704558576043063
Vanuatu,Solomon Islands,9,9,9,38,71,66,64,55,6.111111111111111,0,0,-7,-0.09859154929577464,-2,-0.030303030303030304,VUT,SLB,192074,245453,276438,311685,429978,540394,612660,691191,20.533551502318044,9.25937982410072
Indonesia,Bulgaria,1,6,11,17,22,38,63,62,62,10,0.9090909090909091,41,1.8636363636363635,25,0.6578947368421053,IDN,BGR,214072421,244016173,259091970,271857970,8170172,7395599,7177991,6934015,0.02317386538272172,0.908564518536519
Indonesia,Malta,11,14,18,22,18,30,63,52,4.7272727272727275,7,0.3888888888888889,45,2.5,33,1.1,IDN,MLT,214072421,244016173,259091970,271857970,390087,414508,445053,515332,0.02317386538272172,12.225128654925367
Malaysia,Timor-Leste,134,145,159,169,173,65,63,-71,-0.5298507462686567,25,0.15723270440251572,-110,-0.6358381502890174,-2,-0.03076923076923077,MYS,TLS,22945150,28717731,31068833,33199993,878360,1088486,1205813,1299995,0.18975907615402207,4.84617248527879
Mongolia,Finland,1,7,13,30,42,51,63,62,62,12,0.9230769230769231,21,0.5,12,0.23529411764705882,MNG,FIN,2450979,2702520,2964749,3294335,5176209,5363352,5479531,5529543,1.912373817477579,1.1393346611103305
Nepal,Brazil,0,0,0,0,51,59,63,63,1,0,0,12,0.23529411764705882,4,0.06779661016949153,NPL,BRA,24559500,27161567,27610325,29348627,175873720,196353492,205188205,213196304,0.21466080849369887,0.02955023085203203
Philippines,Slovakia,0,8,19,22,24,34,63,63,1,19,1,39,1.625,29,0.8529411764705882,PHL,SVK,77958223,94636700,103031365,112190977,5388720,5391428,5423801,5458827,0.0561542484829239,1.1540940938410396
South Korea,Papua New Guinea,87,89,66,76,64,64,63,-24,-0.27586206896551724,-21,-0.3181818181818182,-1,-0.015625,-1,-0.015625,KOR,PNG,47008111,49554112,51014947,51836239,5508297,7583269,8682174,9749640,0.12153659527652075,0.6461777050229547
Afghanistan,Nicaragua,27,22,37,54,57,61,62,35,1.2962962962962963,10,0.2702702702702703,5,0.08771929824561403,1,0.01639344262295082,AFG,NIC,19542982,28189672,33753499,38972230,5123222,5855734,6298598,6755895,0.15908763753062116,0.9177170456319999
Indonesia,Sint Maarten (Dutch part),0,0,0,28,57,60,62,62,1,0,0,5,0.08771929824561403,2,0.03333333333333333,IDN,SXM,214072421,244016173,259091970,271857970,30519,34056,38825,40350,0.022806026249662645,153.65551425030978
North Korea,Honduras,48,48,47,46,45,62,62,14,0.2916666666666667,-1,-0.02127659574468085,17,0.37777777777777777,0,0,PRK,HND,23367059,24686435,25258015,25867467,6656725,8450933,9294505,10121763,0.23968330567503965,0.6125415108020213
Papua New Guinea,Philippines,9,12,373,301,59,60,62,53,5.888888888888889,364,0.9758713136729222,3,0.05084745762711865,2,0.03333333333333333,PNG,PHL,5508297,7583269,8682174,9749640,77958223,94636700,103031365,112190977,0.6359209160543363,0.055262911205417174
Portugal,Philippines,25,33,82,66,59,60,62,37,1.48,57,0.6951219512195121,3,0.05084745762711865,2,0.03333333333333333,PRT,PHL,10289898,10573100,10358076,10297081,77958223,94636700,103031365,112190977,0.6021123850535894,0.055262911205417174
South Korea,Nicaragua,20,16,34,54,57,61,62,42,2.1,14,0.4117647058823529,5,0.08771929824561403,1,0.01639344262295082,KOR,NIC,47008111,49554112,51014947,51836239,5123222,5855734,6298598,6755895,0.11960744297054422,0.9177170456319999
Sri Lanka,Estonia,0,0,0,0,9,21,62,62,1,0,0,53,5.888888888888889,41,1.9523809523809523,LKA,EST,18776371,20668557,21336697,21919000,1396985,1331475,1315407,1329522,0.2828596195081893,4.663330129174245
Thailand,Bhutan,28,33,38,48,58,61,62,34,1.2142857142857142,10,0.2631578947368421,4,0.06896551724137931,1,0.01639344262295082,THA,BTN,63066603,68270489,70294397,71475664,587207,705516,743274,772506,0.08674281081180302,8.02582763111225
Timor-Leste,Brazil,0,0,0,0,50,58,62,62,1,0,0,12,0.24,4,0.06896551724137931,TLS,BRA,878360,1088486,1205813,1299995,175873720,196353492,205188205,213196304,4.769249112496587,0.029081179568666446
Afghanistan,Jordan,74,75,76,38,119,49,61,-13,-0.17567567567567569,2,0.02631578947368421,-58,-0.48739495798319327,12,0.24489795918367346,AFG,JOR,19542982,28189672,33753499,38972230,5056174,6931258,9494246,10928721,0.1565217078930305,0.5581622954781259
India,Croatia,0,0,0,34,67,67,61,61,1,0,0,-6,-0.08955223880597014,-6,-0.08955223880597014,IND,HRV,1059633675,1240613620,1322866505,1396387127,4468302,4295427,4203604,4047680,0.004368416094686613,1.5070361293382875
Malaysia,Greece,63,55,47,56,66,61,61,-2,-0.031746031746031744,-16,-0.3404255319148936,-5,-0.07575757575757576,0,0,MYS,GRC,22945150,28717731,31068833,33199993,10805808,11121341,10820883,10698599,0.18373497849833884,0.5701681126659668
Sri Lanka,Lithuania,0,0,0,0,0,3,61,61,1,0,0,61,1,58,19.333333333333332,LKA,LTU,18776371,20668557,21336697,21919000,3499536,3097282,2904910,2794885,0.27829736758063783,2.182558495251146
Cambodia,Czechia,4,6,8,15,20,40,60,56,14,4,0.5,40,2,20,0.5,KHM,CZE,12118841,14363532,15417523,16396860,10255063,10474410,10546059,10697858,0.3659237195414244,0.5608599403731102
Finland,Sri Lanka,0,6,14,29,61,61,60,60,1,14,1,-1,-0.01639344262295082,-1,-0.01639344262295082,FIN,LKA,5176209,5363352,5479531,5529543,18776371,20668557,21336697,21919000,1.0850806296288862,0.27373511565308634
Iran,Lithuania,24,27,21,55,82,121,60,36,1.5,-3,-0.14285714285714285,-22,-0.2682926829268293,-61,-0.5041322314049587,IRN,LTU,65544383,75373855,81790841,87290193,3499536,3097282,2904910,2794885,0.06873624394437987,2.1467788477880125
Malaysia,Mauritius,36,33,49,49,53,61,60,24,0.6666666666666666,13,0.2653061224489796,7,0.1320754716981132,-1,-0.01639344262295082,MYS,MUS,22945150,28717731,31068833,33199993,1186873,1250400,1262879,1266014,0.18072292967049722,4.73928408374631
Malaysia,Mexico,23,41,61,55,55,57,60,37,1.608695652173913,38,0.6229508196721312,5,0.09090909090909091,3,0.05263157894736842,MYS,MEX,22945150,28717731,31068833,33199993,97873442,112532401,120149897,125998302,0.18072292967049722,0.04761968935105173
Philippines,Puerto Rico,274,289,306,239,143,140,60,-214,-0.781021897810219,32,0.10457516339869281,-83,-0.5804195804195804,-80,-0.5714285714285714,PHL,PRI,77958223,94636700,103031365,112190977,3810605,3721525,3473232,3281557,0.05348023665040372,1.8284003599510843
Thailand,Argentina,133,130,127,95,60,60,60,-73,-0.5488721804511278,-6,-0.047244094488188976,0,0,0,0,THA,ARG,63066603,68270489,70294397,71475664,37070774,40788453,43131966,45376763,0.0839446556243255,0.1322262674400111
Thailand,Cayman Islands,16,32,56,51,51,55,60,44,2.75,40,0.7142857142857143,9,0.17647058823529413,5,0.09090909090909091,THA,CYM,63066603,68270489,70294397,71475664,39658,54074,60911,67311,0.0839446556243255,89.1384766234345
Thailand,Timor-Leste,119,130,143,152,155,62,60,-59,-0.4957983193277311,24,0.16783216783216784,-95,-0.6129032258064516,-2,-0.03225806451612903,THA,TLS,63066603,68270489,70294397,71475664,878360,1088486,1205813,1299995,0.0839446556243255,4.61540236693218
Vietnam,Cyprus,16,23,29,44,65,59,60,44,2.75,13,0.4482758620689655,-5,-0.07692307692307693,1,0.01694915254237288,VNM,CYP,79001142,87411012,92191398,96648685,948237,1129686,1187280,1237537,0.0620805135631178,4.84833988801951
South Korea,Faroe Islands,63,53,37,42,47,53,59,-4,-0.06349206349206349,-26,-0.7027027027027027,12,0.2553191489361702,6,0.11320754716981132,KOR,FRO,47008111,49554112,51014947,51836239,45660,48410,48816,52415,0.11381998605261466,112.56319755795097
Hong Kong,Russian Federation,38,36,34,46,58,60,58,20,0.5263157894736842,-4,-0.11764705882352941,0,0,-2,-0.03333333333333333,HKG,RUS,6665000,7024200,7291300,7481000,146596869,142849468,144640716,145245148,0.7752974201309984,0.039932487107934234
North Korea,Belarus,97,80,62,60,57,60,58,-39,-0.4020618556701031,-35,-0.5645161290322581,1,0.017543859649122806,-2,-0.03333333333333333,PRK,BLR,23367059,24686435,25258015,25867467,9979610,9483836,9461076,9379952,0.2242198665992306,0.6183400512070851
Philippines,Liechtenstein,0,0,1,18,37,38,58,58,1,1,1,21,0.5675675675675675,20,0.5263157894736842,PHL,LIE,77958223,94636700,103031365,112190977,33026,35926,37355,38756,0.051697562095390254,149.65424708432244
Philippines,Lithuania,0,0,0,0,0,0,58,58,1,0,0,58,1,58,1,PHL,LTU,77958223,94636700,103031365,112190977,3499536,3097282,2904910,2794885,0.051697562095390254,2.075219552861746
South Korea,Cambodia,26,68,110,86,62,56,58,32,1.2307692307692308,84,0.7636363636363637,-4,-0.06451612903225806,2,0.03571428571428571,KOR,KHM,47008111,49554112,51014947,51836239,12118841,14363532,15417523,16396860,0.11189083374663815,0.3537262622233769
Vietnam,Portugal,5,12,20,37,48,53,58,53,10.6,15,0.75,10,0.20833333333333334,5,0.09433962264150944,VNM,PRT,79001142,87411012,92191398,96648685,10289898,10573100,10358076,10297081,0.06001116311101388,0.5632664247275514
Philippines,Argentina,128,125,122,91,58,58,57,-71,-0.5546875,-6,-0.04918032786885246,-1,-0.017241379310344827,-1,-0.017241379310344827,PHL,ARG,77958223,94636700,103031365,112190977,37070774,40788453,43131966,45376763,0.05080622481788352,0.12561495406801051
Thailand,Bulgaria,3,5,7,10,12,30,57,54,18,4,0.5714285714285714,45,3.75,27,0.9,THA,BGR,63066603,68270489,70294397,71475664,8170172,7395599,7177991,6934015,0.07974742284310923,0.8220345643901837
United States of America,Timor-Leste,64,64,66,70,72,59,57,-7,-0.109375,2,0.030303030303030304,-15,-0.20833333333333334,-2,-0.03389830508474576,USA,TLS,282162411,309327143,320738994,331526933,878360,1088486,1205813,1299995,0.01719317326173316,4.3846322485855715
Laos,Finland,0,3,5,13,15,42,56,56,1,5,1,41,2.7333333333333334,14,0.3333333333333333,LAO,FIN,5430853,6323418,6787419,7319399,5176209,5363352,5479531,5529543,0.7650901392313768,1.0127419209869604
Fiji,Tuvalu,114,81,60,54,48,51,55,-59,-0.5175438596491229,-54,-0.9,7,0.14583333333333334,4,0.0784313725490196,FJI,TUV,832509,905169,917200,920422,9638,10550,10877,11069,5.975519924556345,496.88318727979043
Iceland,Philippines,0,0,58,46,53,53,55,55,1,58,1,2,0.03773584905660377,2,0.03773584905660377,ISL,PHL,281205,318041,330815,366463,77958223,94636700,103031365,112190977,15.008336448700142,0.04902355026287007
Kenya,Philippines,4,5,275,222,53,53,55,51,12.75,271,0.9854545454545455,2,0.03773584905660377,2,0.03773584905660377,KEN,PHL,30851606,41517895,46851488,51985780,77958223,94636700,103031365,112190977,0.10579816249751375,0.04902355026287007
Bangladesh,Mexico,35,24,15,31,50,51,54,19,0.5428571428571428,-20,-1.3333333333333333,4,0.08,3,0.058823529411764705,BGD,MEX,129193327,148391139,157830000,167420951,97873442,112532401,120149897,125998302,0.03225402775307375,0.04285772041594656
China,Bermuda,85,128,145,96,40,65,54,-31,-0.36470588235294116,60,0.41379310344827586,14,0.35,-11,-0.16923076923076924,CHN,BMU,1262645000,1337705000,1379860000,1411100000,61833,65124,65237,63893,0.0038268017858408333,84.51630069021645
Indonesia,Venezuela (Bolivarian Republic of),52,51,51,53,56,59,54,2,0.038461538461538464,-1,-0.0196078431372549,-2,-0.03571428571428571,-5,-0.0847457627118644,IDN,VEN,214072421,244016173,259091970,271857970,24427729,28715022,30529716,28490453,0.019863313185190044,0.18953717583921884
Israel,Sri Lanka,0,5,12,26,55,55,54,54,1,12,1,-1,-0.01818181818181818,-1,-0.01818181818181818,ISR,LKA,6289000,7623600,8380100,9215100,18776371,20668557,21336697,21919000,0.5859947260474656,0.24636160408777774
Malaysia,Portugal,10,23,37,43,43,49,54,44,4.4,27,0.7297297297297297,11,0.2558139534883721,5,0.10204081632653061,MYS,PRT,22945150,28717731,31068833,33199993,10289898,10573100,10358076,10297081,0.1626506367034475,0.5244204644015134
Myanmar,Cambodia,24,63,102,80,58,52,54,30,1.25,78,0.7647058823529411,-4,-0.06896551724137931,2,0.038461538461538464,MMR,KHM,45538332,49390988,51483949,53423198,12118841,14363532,15417523,16396860,0.10107968452206849,0.329331347587282
Nepal,Cyprus,14,20,26,39,59,54,54,40,2.857142857142857,12,0.46153846153846156,-5,-0.0847457627118644,0,0,NPL,CYP,24559500,27161567,27610325,29348627,948237,1129686,1187280,1237537,0.18399497870888473,4.363505899217559
Bangladesh,Bhutan,24,28,33,41,49,52,53,29,1.2083333333333333,9,0.2727272727272727,4,0.08163265306122448,1,0.019230769230769232,BGD,BTN,129193327,148391139,157830000,167420951,587207,705516,743274,772506,0.03165673094283164,6.860788136273375
Fiji,South Africa,47,29,20,25,36,46,53,6,0.1276595744680851,-27,-1.35,17,0.4722222222222222,7,0.15217391304347827,FJI,ZAF,832509,905169,917200,920422,46813266,51784921,55876504,58801927,5.758228290936114,0.09013310056998643
Mongolia,Lithuania,79,88,68,76,75,62,53,-26,-0.3291139240506329,-11,-0.16176470588235295,-22,-0.29333333333333333,-9,-0.14516129032258066,MNG,LTU,2450979,2702520,2964749,3294335,3499536,3097282,2904910,2794885,1.608822417877963,1.8963213155460779
Puerto Rico,Philippines,8,10,54,43,51,51,53,45,5.625,46,0.8518518518518519,2,0.0392156862745098,2,0.0392156862745098,PRI,PHL,3810605,3721525,3473232,3281557,77958223,94636700,103031365,112190977,1.615086984623458,0.047240875707856615
Vietnam,Estonia,0,0,0,0,11,32,53,53,1,0,0,42,3.8181818181818183,21,0.65625,VNM,EST,79001142,87411012,92191398,96648685,1396985,1331475,1315407,1329522,0.054837786980754054,3.9863951104231443
Malaysia,Poland,11,9,8,24,42,39,52,41,3.727272727272727,-3,-0.375,10,0.23809523809523808,13,0.3333333333333333,MYS,POL,22945150,28717731,31068833,33199993,38258629,38042794,37986412,37899070,0.15662653904776425,0.1372065330362988
Philippines,Bolivia (Plurinational State of),14,26,37,39,40,48,52,38,2.7142857142857144,23,0.6216216216216216,12,0.3,4,0.08333333333333333,PHL,BOL,77958223,94636700,103031365,112190977,8592656,10223270,11090085,11936162,0.04634953843034988,0.4356509236386034
Bangladesh,Panama,7,9,13,22,36,42,51,44,6.285714285714286,6,0.46153846153846156,15,0.4166666666666667,9,0.21428571428571427,BGD,PAN,129193327,148391139,157830000,167420951,3001731,3623617,3957099,4294396,0.030462137322347427,1.1875942507398014
Laos,Luxembourg,0,0,0,0,0,0,51,51,1,0,0,51,1,51,1,LAO,LUX,5430853,6323418,6787419,7319399,436300,506953,569604,630419,0.6967785196571468,8.089857697816848
Philippines,Dominican Republic,115,128,140,94,49,50,51,-64,-0.5565217391304348,25,0.17857142857142858,2,0.04081632653061224,1,0.02,PHL,DOM,77958223,94636700,103031365,112190977,8540791,9775755,10405832,10999664,0.04545820115284315,0.4636505260524321
Indonesia,Slovakia,0,7,17,20,22,35,50,50,1,17,1,28,1.2727272727272727,15,0.42857142857142855,IDN,SVK,214072421,244016173,259091970,271857970,5388720,5391428,5423801,5458827,0.018391956652953744,0.9159476935246346
Libya,Philippines,32,43,44,35,47,48,50,18,0.5625,12,0.2727272727272727,3,0.06382978723404255,2,0.041666666666666664,LBY,PHL,5154790,6491988,6192235,6653942,77958223,94636700,103031365,112190977,0.7514342625769806,0.04456686387533643
Myanmar,Turkey,18,21,36,37,38,37,50,32,1.7777777777777777,18,0.5,12,0.3157894736842105,13,0.35135135135135137,MMR,TUR,45538332,49390988,51483949,53423198,64113547,73142150,78218479,83384680,0.09359230048339674,0.059963053165161755
Singapore,Papua New Guinea,71,72,53,61,51,51,50,-21,-0.29577464788732394,-18,-0.33962264150943394,-1,-0.0196078431372549,-1,-0.0196078431372549,SGP,PNG,4027887,5076732,5535002,5685807,5508297,7583269,8682174,9749640,0.879382645242795,0.5128394484309164
Vietnam,Ecuador,16,18,20,25,38,48,50,34,2.125,4,0.2,12,0.3157894736842105,2,0.041666666666666664,VNM,ECU,79001142,87411012,92191398,96648685,12626507,14989585,16195902,17588595,0.051733761302598165,0.2842751226007535
China,Saint Lucia,21,27,38,48,55,52,49,28,1.3333333333333333,17,0.4473684210526316,-6,-0.10909090909090909,-3,-0.057692307692307696,CHN,LCA,1262645000,1337705000,1379860000,1411100000,159500,170935,175623,179237,0.003472468287151867,27.338105413502788
South Korea,Iceland,27,29,31,16,35,37,49,22,0.8148148148148148,4,0.12903225806451613,14,0.4,12,0.32432432432432434,KOR,ISL,47008111,49554112,51014947,51836239,281205,318041,330815,366463,0.09452846299284946,13.371063381569217
Sri Lanka,Malta,9,11,13,17,14,23,49,40,4.444444444444445,4,0.3076923076923077,35,2.5,26,1.1304347826086956,LKA,MLT,18776371,20668557,21336697,21919000,390087,414508,445053,515332,0.22355034445002053,9.508433398275287
Malaysia,Bermuda,13,18,19,33,49,42,48,35,2.6923076923076925,6,0.3157894736842105,-1,-0.02040816326530612,6,0.14285714285714285,MYS,BMU,22945150,28717731,31068833,33199993,61833,65124,65237,63893,0.14457834373639777,75.12560061352573
Malaysia,Iceland,5,7,9,19,28,35,48,43,8.6,4,0.4444444444444444,20,0.7142857142857143,13,0.37142857142857144,MYS,ISL,22945150,28717731,31068833,33199993,281205,318041,330815,366463,0.14457834373639777,13.098184537047397
South Korea,Slovenia,0,0,0,0,19,25,48,48,1,0,0,29,1.5263157894736843,23,0.92,KOR,SVN,47008111,49554112,51014947,51836239,1988925,2048583,2063531,2102419,0.09259931068687295,2.283084389933691
Sri Lanka,Cambodia,22,58,93,73,52,47,48,26,1.1818181818181819,71,0.7634408602150538,-4,-0.07692307692307693,1,0.02127659574468085,LKA,KHM,18776371,20668557,21336697,21919000,12118841,14363532,15417523,16396860,0.2189880925224691,0.2927389756331395
Iran,Belarus,25,38,51,49,47,49,47,22,0.88,26,0.5098039215686274,0,0,-2,-0.04081632653061224,IRN,BLR,65544383,75373855,81790841,87290193,9979610,9483836,9461076,9379952,0.05384339108976423,0.5010686621850516
Thailand,Guinea,0,0,0,0,0,51,47,47,1,0,0,47,1,-4,-0.0784313725490196,THA,GIN,63066603,68270489,70294397,71475664,8336967,10270728,11625998,13205153,0.06575664690572164,0.3559216617936952
Afghanistan,Latvia,20,22,24,24,25,27,46,26,1.3,4,0.16666666666666666,21,0.84,19,0.7037037037037037,AFG,LVA,19542982,28189672,33753499,38972230,2367550,2097555,1977527,1900449,0.11803276332917054,2.420480633787068
China,Samoa,93,84,75,70,62,50,46,-47,-0.5053763440860215,-18,-0.24,-16,-0.25806451612903225,-4,-0.08,CHN,WSM,1262645000,1337705000,1379860000,1411100000,184008,194672,203571,214929,0.0032598681879384877,21.402416611997452
China,Tajikistan,74,60,52,50,49,48,46,-28,-0.3783783783783784,-22,-0.4230769230769231,-3,-0.061224489795918366,-2,-0.041666666666666664,CHN,TJK,1262645000,1337705000,1379860000,1411100000,6272998,7621779,8524063,9543207,0.0032598681879384877,0.4820182565462533
India,Belarus,24,37,50,48,46,48,46,22,0.9166666666666666,26,0.52,0,0,-2,-0.041666666666666664,IND,BLR,1059633675,1240613620,1322866505,1396387127,9979610,9483836,9461076,9379952,0.003294215415665315,0.4904076268194123
Iran,Latvia,15,22,30,34,38,35,46,31,2.066666666666667,15,0.5,8,0.21052631578947367,11,0.3142857142857143,IRN,LVA,65544383,75373855,81790841,87290193,2367550,2097555,1977527,1900449,0.05269778702402456,2.420480633787068
Mongolia,Estonia,28,43,58,56,53,50,46,18,0.6428571428571429,30,0.5172413793103449,-7,-0.1320754716981132,-4,-0.08,MNG,EST,2450979,2702520,2964749,3294335,1396985,1331475,1315407,1329522,1.3963364381582322,3.4598900958389556
Nepal,Cambodia,21,55,89,69,50,45,46,25,1.1904761904761905,68,0.7640449438202247,-4,-0.08,1,0.022222222222222223,NPL,KHM,24559500,27161567,27610325,29348627,12118841,14363532,15417523,16396860,0.15673646334460553,0.28054151831509205
South Korea,Micronesia (Fed. States of),65,58,54,50,48,47,46,-19,-0.2923076923076923,-11,-0.2037037037037037,-2,-0.041666666666666664,-1,-0.02127659574468085,KOR,FSM,47008111,49554112,51014947,51836239,111709,107588,109462,112106,0.0887410060749199,41.03259415196332
United States of America,Maldives,24,20,16,32,38,44,46,22,0.9166666666666666,-8,-0.5,8,0.21052631578947367,2,0.045454545454545456,USA,MDV,282162411,309327143,320738994,331526933,282507,361575,435582,514438,0.013875192456837286,8.941796679094468
India,British Virgin Islands,20,24,27,31,35,40,45,25,1.25,7,0.25925925925925924,10,0.2857142857142857,5,0.125,IND,VGB,1059633675,1240613620,1322866505,1396387127,20104,27556,29366,30910,0.003222602037063895,145.5839534131349
India,Guinea,0,0,0,0,0,49,45,45,1,0,0,45,1,-4,-0.08163265306122448,IND,GIN,1059633675,1240613620,1322866505,1396387127,8336967,10270728,11625998,13205153,0.003222602037063895,0.3407760591641763
Nepal,Latvia,1,1,2,8,14,16,45,44,44,1,0.5,31,2.2142857142857144,29,1.8125,NPL,LVA,24559500,27161567,27610325,29348627,2367550,2097555,1977527,1900449,0.15332914892407062,2.367861489574306
Pakistan,Belarus,24,37,49,47,45,47,45,21,0.875,25,0.5102040816326531,0,0,-2,-0.0425531914893617,PAK,BLR,154369924,194454498,210969298,227196741,9979610,9483836,9461076,9379952,0.01980662213812301,0.47974659145377285
Afghanistan,Namibia,64,61,58,45,43,42,44,-20,-0.3125,-6,-0.10344827586206896,1,0.023255813953488372,2,0.047619047619047616,AFG,NAM,19542982,28189672,33753499,38972230,1819141,2099271,2282704,2489098,0.11290090405398921,1.767708623766521
Afghanistan,Romania,0,0,0,0,0,0,44,44,1,0,0,44,1,44,1,AFG,ROU,19542982,28189672,33753499,38972230,22442971,20246871,19815616,19265250,0.11290090405398921,0.22839049584095716
Bangladesh,Lithuania,0,0,0,0,0,5,44,44,1,0,0,44,1,39,7.8,BGD,LTU,129193327,148391139,157830000,167420951,3499536,3097282,2904910,2794885,0.02628105965065268,1.574304488377876
Iran,Croatia,0,0,0,24,48,48,44,44,1,0,0,-4,-0.08333333333333333,-4,-0.08333333333333333,IRN,HRV,65544383,75373855,81790841,87290193,4468302,4295427,4203604,4047680,0.05040657889254524,1.0870424539489287
Malaysia,Cyprus,11,16,20,31,48,43,44,33,3,9,0.45,-4,-0.08333333333333333,1,0.023255813953488372,MYS,CYP,22945150,28717731,31068833,33199993,948237,1129686,1187280,1237537,0.1325301484250313,3.5554492512143074
Myanmar,Cyprus,11,16,20,31,48,43,44,33,3,9,0.45,-4,-0.08333333333333333,1,0.023255813953488372,MMR,CYP,45538332,49390988,51483949,53423198,948237,1129686,1187280,1237537,0.08236122442538914,3.5554492512143074
Turkey,Sri Lanka,0,4,10,22,45,45,44,44,1,10,1,-1,-0.022222222222222223,-1,-0.022222222222222223,TUR,LKA,64113547,73142150,78218479,83384680,18776371,20668557,21336697,21919000,0.05276748678534234,0.20073908481226332
Canada,Cambodia,20,53,85,66,47,42,43,23,1.15,65,0.7647058823529411,-4,-0.0851063829787234,1,0.023809523809523808,CAN,KHM,30685730,34005902,35704498,38028638,12118841,14363532,15417523,16396860,0.11307267959478327,0.26224533233802083
Maldives,Russian Federation,135,124,109,77,45,45,43,-92,-0.6814814814814815,-26,-0.23853211009174313,-2,-0.044444444444444446,-2,-0.044444444444444446,MDV,RUS,282507,361575,435582,514438,146596869,142849468,144640716,145245148,8.358636026110046,0.029605119752434003
North Korea,Cambodia,20,53,85,66,47,42,43,23,1.15,65,0.7647058823529411,-4,-0.0851063829787234,1,0.023809523809523808,PRK,KHM,23367059,24686435,25258015,25867467,12118841,14363532,15417523,16396860,0.16623197006494683,0.26224533233802083
North Korea,Venezuela (Bolivarian Republic of),41,40,40,41,44,46,43,2,0.04878048780487805,-1,-0.025,-1,-0.022727272727272728,-3,-0.06521739130434782,PRK,VEN,23367059,24686435,25258015,25867467,24427729,28715022,30529716,28490453,0.16623197006494683,0.15092775113122983
China,Barbados,0,0,0,30,41,43,42,42,1,0,0,1,0.024390243902439025,-1,-0.023255813953488372,CHN,BRB,1262645000,1337705000,1379860000,1411100000,264657,274711,278083,280693,0.002976401388987315,14.96296665752263
China,Cuba,658,499,351,223,134,76,42,-616,-0.9361702127659575,-307,-0.8746438746438746,-92,-0.6865671641791045,-34,-0.4473684210526316,CHN,CUB,1262645000,1337705000,1379860000,1411100000,11105791,11290417,11339894,11300698,0.002976401388987315,0.3716584586191048
Fiji,Spain,3,6,72,35,31,32,42,39,13,69,0.9583333333333334,11,0.3548387096774194,10,0.3125,FJI,ESP,832509,905169,917200,920422,40567864,46576897,46444832,47365655,4.563124306024846,0.08867184460977051
Indonesia,Guatemala,27,26,25,30,35,39,42,15,0.5555555555555556,-2,-0.08,7,0.2,3,0.07692307692307693,IDN,GTM,214072421,244016173,259091970,271857970,11589761,14259687,15567419,16858333,0.015449243588481145,0.24913495302293528
Mongolia,Luxembourg,0,0,0,0,0,0,42,42,1,0,0,42,1,42,1,MNG,LUX,2450979,2702520,2964749,3294335,436300,506953,569604,630419,1.274915878318386,6.662235751143287
North Korea,Costa Rica,21,20,28,19,37,36,42,21,1,7,0.25,5,0.13513513513513514,6,0.16666666666666666,PRK,CRI,23367059,24686435,25258015,25867467,3979193,4622252,4895242,5123105,0.16236611029599457,0.8198153268379236
Pakistan,Cambodia,19,50,81,63,45,41,42,23,1.2105263157894737,62,0.7654320987654321,-3,-0.06666666666666667,1,0.024390243902439025,PAK,KHM,154369924,194454498,210969298,227196741,12118841,14363532,15417523,16396860,0.018486180662248143,0.2561466036789971
Pakistan,Slovenia,3,5,13,16,18,26,42,39,13,10,0.7692307692307693,24,1.3333333333333333,16,0.6153846153846154,PAK,SVN,154369924,194454498,210969298,227196741,1988925,2048583,2063531,2102419,0.018486180662248143,1.9976988411919792
Philippines,Serbia,5,33,46,46,45,43,42,37,7.4,41,0.8913043478260869,-3,-0.06666666666666667,-1,-0.023255813953488372,PHL,SRB,77958223,94636700,103031365,112190977,7516346,7291436,7095383,6899126,0.0374361656552826,0.6087727633906093
Sri Lanka,Nepal,78,98,87,77,42,46,42,-36,-0.46153846153846156,9,0.10344827586206896,0,0,-4,-0.08695652173913043,LKA,NPL,18776371,20668557,21336697,21919000,24559500,27161567,27610325,29348627,0.19161458095716047,0.1431072056624659
Afghanistan,Lithuania,40,45,35,31,24,20,41,1,0.025,-5,-0.14285714285714285,17,0.7083333333333334,21,1.05,AFG,LTU,19542982,28189672,33753499,38972230,3499536,3097282,2904910,2794885,0.10520311514121722,1.4669655459884754
Fiji,Norway,12,17,24,27,40,41,41,29,2.4166666666666665,12,0.5,1,0.025,0,0,FJI,NOR,832509,905169,917200,920422,4490967,4889252,5188607,5379475,4.454478489214729,0.7621561583611784
Ireland,Papua New Guinea,67,68,50,50,42,42,41,-26,-0.3880597014925373,-17,-0.34,-1,-0.023809523809523808,-1,-0.023809523809523808,IRL,PNG,3805174,4560155,4701957,4985382,5508297,7583269,8682174,9749640,0.822404381449606,0.42052834771335146
Afghanistan,Georgia,0,0,42,39,39,40,40,40,1,42,1,1,0.02564102564102564,0,0,AFG,GEO,19542982,28189672,33753499,38972230,4077131,3786695,3725276,3722716,0.10263718550362656,1.0744843281088323
Cambodia,Philippines,7528,10130,186,150,38,39,40,-7488,-0.9946865037194474,-7342,-39.473118279569896,2,0.05263157894736842,1,0.02564102564102564,KHM,PHL,12118841,14363532,15417523,16396860,77958223,94636700,103031365,112190977,0.24394914636094958,0.03565349110026914
Costa Rica,Philippines,21,28,29,23,38,39,40,19,0.9047619047619048,8,0.27586206896551724,2,0.05263157894736842,1,0.02564102564102564,CRI,PHL,3979193,4622252,4895242,5123105,77958223,94636700,103031365,112190977,0.7807765017504034,0.03565349110026914
Indonesia,Estonia,0,0,0,0,6,12,40,40,1,0,0,34,5.666666666666667,28,2.3333333333333335,IDN,EST,214072421,244016173,259091970,271857970,1396985,1331475,1315407,1329522,0.014713565322362997,3.008600083338222
Laos,Greece,6,6,6,24,43,40,40,34,5.666666666666667,0,0,-3,-0.06976744186046512,0,0,LAO,GRC,5430853,6323418,6787419,7319399,10805808,11121341,10820883,10698599,0.5464929565938406,0.37388072961702745
Laos,Liechtenstein,0,0,1,17,35,36,40,40,1,1,1,5,0.14285714285714285,4,0.1111111111111111,LAO,LIE,5430853,6323418,6787419,7319399,33026,35926,37355,38756,0.5464929565938406,103.20982557539477
Mongolia,Romania,0,0,0,0,0,10,40,40,1,0,0,40,1,30,3,MNG,ROU,2450979,2702520,2964749,3294335,22442971,20246871,19815616,19265250,1.2142055983984628,0.20762772349177924
Sri Lanka,Bahamas,24,16,9,23,36,39,40,16,0.6666666666666666,-15,-1.6666666666666667,4,0.1111111111111111,1,0.02564102564102564,LKA,BHS,18776371,20668557,21336697,21919000,325014,373272,392697,406471,0.18249007710205759,9.840800450708661
Vietnam,Lithuania,66,74,57,52,40,35,40,-26,-0.3939393939393939,-9,-0.15789473684210525,0,0,5,0.14285714285714285,VNM,LTU,79001142,87411012,92191398,96648685,3499536,3097282,2904910,2794885,0.04138700904207853,1.4311858985253418
Fiji,Italy,3,10,17,31,39,38,39,36,12,14,0.8235294117647058,0,0,1,0.02631578947368421,FJI,ITA,832509,905169,917200,920422,56942108,59277417,60730582,59438851,4.2371868555945,0.06561365057342713
Germany,Cambodia,18,47,76,59,42,38,39,21,1.1666666666666667,58,0.7631578947368421,-3,-0.07142857142857142,1,0.02631578947368421,DEU,KHM,82211508,81776930,81686611,83160871,12118841,14363532,15417523,16396860,0.04689705570784606,0.23785041770192586
Iraq,Sri Lanka,0,4,9,19,40,40,39,39,1,9,1,-1,-0.025,-1,-0.025,IRQ,LKA,24628858,31264875,37757813,42556984,18776371,20668557,21336697,21919000,0.09164183251331909,0.17792782517450614
Libya,Sri Lanka,0,4,9,19,40,40,39,39,1,9,1,-1,-0.025,-1,-0.025,LBY,LKA,5154790,6491988,6192235,6653942,18776371,20668557,21336697,21919000,0.5861187248100449,0.17792782517450614
Papua New Guinea,Spain,1,3,47,23,28,30,39,38,38,46,0.9787234042553191,11,0.39285714285714285,9,0.3,PNG,ESP,5508297,7583269,8682174,9749640,40567864,46576897,46444832,47365655,0.4000147697761148,0.08233814142335834
Vietnam,Turkey,7,17,29,30,30,29,39,32,4.571428571428571,22,0.7586206896551724,9,0.3,10,0.3448275862068966,VNM,TUR,79001142,87411012,92191398,96648685,64113547,73142150,78218479,83384680,0.04035233381602657,0.04677118146882617
Denmark,Bhutan,18,21,24,30,36,38,38,20,1.1111111111111112,6,0.25,2,0.05555555555555555,0,0,DNK,BTN,5339616,5547683,5683483,5831404,587207,705516,743274,772506,0.6516440980594038,4.91905564487525
Egypt,Maldives,15,24,33,27,32,37,38,23,1.5333333333333334,18,0.5454545454545454,6,0.1875,1,0.02702702702702703,EGY,MDV,71371371,87252413,97723799,107465134,282507,361575,435582,514438,0.03536030578996905,7.386701604469343
India,French Polynesia,35,38,41,42,41,38,38,3,0.08571428571428572,6,0.14634146341463414,-3,-0.07317073170731707,0,0,IND,PYF,1059633675,1240613620,1322866505,1396387127,250927,283788,291787,301920,0.0027213083868539555,12.586115527292
Pakistan,Ecuador,18,20,22,27,42,29,38,20,1.1111111111111112,4,0.18181818181818182,-4,-0.09523809523809523,9,0.3103448275862069,PAK,ECU,154369924,194454498,210969298,227196741,12626507,14989585,16195902,17588595,0.016725592027748322,0.21604909317657264
Papua New Guinea,Italy,3,9,14,23,33,615,38,35,11.666666666666666,11,0.7857142857142857,5,0.15151515151515152,-577,-0.9382113821138212,PNG,ITA,5508297,7583269,8682174,9749640,56942108,59277417,60730582,59438851,0.3897579808074965,0.0639312492766726
United Kingdom,Solomon Islands,85,85,81,59,42,39,38,-47,-0.5529411764705883,-4,-0.04938271604938271,-4,-0.09523809523809523,-1,-0.02564102564102564,GBR,SLB,58892514,62766365,65116219,67081234,429978,540394,612660,691191,0.05664773549037575,5.497756770559802
Australia,Vietnam,16,28,45,36,32,37,37,21,1.3125,29,0.6444444444444445,5,0.15625,0,0,AUS,VNM,19028802,22031750,23815995,25649248,79001142,87411012,92191398,96648685,0.14425374186408896,0.03828298336392265
Canada,Bhutan,17,20,23,29,35,37,37,20,1.1764705882352942,6,0.2608695652173913,2,0.05714285714285714,0,0,CAN,BTN,30685730,34005902,35704498,38028638,587207,705516,743274,772506,0.09729509639551119,4.789606812115376
China,Dominica,14,19,23,27,33,38,37,23,1.6428571428571428,9,0.391304347826087,4,0.12121212121212122,-1,-0.02631578947368421,CHN,DMA,1262645000,1337705000,1379860000,1411100000,68346,68755,70007,71995,0.0026220678902983486,51.39245780957011
Hong Kong,Jordan,1,24,47,36,73,30,37,36,36,46,0.9787234042553191,-36,-0.4931506849315068,7,0.23333333333333334,HKG,JOR,6665000,7024200,7291300,7481000,5056174,6931258,9494246,10928721,0.49458628525598186,0.33855745791296166
Laos,Ireland,6,18,39,39,33,34,37,31,5.166666666666667,33,0.8461538461538461,4,0.12121212121212122,3,0.08823529411764706,LAO,IRL,5430853,6323418,6787419,7319399,3805174,4560155,4701957,4985382,0.5055059848493025,0.7421698076496445
Maldives,Seychelles,2,1,1,17,34,38,37,35,17.5,-1,-1,3,0.08823529411764706,-1,-0.02631578947368421,MDV,SYC,282507,361575,435582,514438,81131,89770,93419,98462,7.192314720141202,37.577948853364745
North Korea,Bulgaria,1,1,1,18,33,29,37,36,36,0,0,4,0.12121212121212122,8,0.27586206896551724,PRK,BGR,23367059,24686435,25258015,25867467,8170172,7395599,7177991,6934015,0.14303681145123331,0.5336013839024
North Korea,Turkey,7,17,28,29,29,28,37,30,4.285714285714286,21,0.75,8,0.27586206896551724,9,0.32142857142857145,PRK,TUR,23367059,24686435,25258015,25867467,64113547,73142150,78218479,83384680,0.14303681145123331,0.0443726593422197
Sweden,Maldives,11,24,36,26,31,36,37,26,2.3636363636363638,25,0.6944444444444444,6,0.1935483870967742,1,0.027777777777777776,SWE,MDV,8872109,9378126,9799186,10353442,282507,361575,435582,514438,0.3573690759073166,7.192314720141202
Thailand,Peru,12,13,16,19,20,21,37,25,2.0833333333333335,4,0.25,17,0.85,16,0.7619047619047619,THA,PER,63066603,68270489,70294397,71475664,26654439,29229572,30711863,33304756,0.051765870968334064,0.11109524417473587
Afghanistan,Slovenia,1,2,0,0,5,25,36,35,35,-1,1,31,6.2,11,0.44,AFG,SVN,19542982,28189672,33753499,38972230,1988925,2048583,2063531,2102419,0.0923734669532639,1.7123132924502678
Bhutan,Sweden,7,9,10,19,30,25,36,29,4.142857142857143,3,0.3,6,0.2,11,0.44,BTN,SWE,587207,705516,743274,772506,8872109,9378126,9799186,10353442,4.6601579793555,0.34771045223414593
Bolivia (Plurinational State of),Philippines,108,145,531,429,34,35,36,-72,-0.6666666666666666,423,0.7966101694915254,2,0.058823529411764705,1,0.02857142857142857,BOL,PHL,8592656,10223270,11090085,11936162,77958223,94636700,103031365,112190977,0.3016044855959562,0.03208814199024223
Haiti,Sri Lanka,0,3,8,18,38,37,36,36,1,8,1,-2,-0.05263157894736842,-1,-0.02702702702702703,HTI,LKA,8360225,9842880,10563757,11306801,18776371,20668557,21336697,21919000,0.31839244362751234,0.16424106939185182
North Korea,Norway,26,23,25,27,40,37,36,10,0.38461538461538464,-1,-0.04,-4,-0.1,-1,-0.02702702702702703,PRK,NOR,23367059,24686435,25258015,25867467,4490967,4889252,5188607,5379475,0.13917095168228108,0.6692102853903029
Papua New Guinea,Samoa,24,41,58,54,48,40,36,12,0.5,34,0.5862068965517241,-12,-0.25,-4,-0.1,PNG,WSM,5508297,7583269,8682174,9749640,184008,194672,203571,214929,0.36924440287025984,16.749717348519745
Romania,Philippines,2,2,154,124,34,35,36,34,17,152,0.987012987012987,2,0.058823529411764705,1,0.02857142857142857,ROU,PHL,22442971,20246871,19815616,19265250,77958223,94636700,103031365,112190977,0.18686495114260132,0.03208814199024223
United Kingdom,Bhutan,17,19,22,28,34,36,36,19,1.1176470588235294,5,0.22727272727272727,2,0.058823529411764705,0,0,GBR,BTN,58892514,62766365,65116219,67081234,587207,705516,743274,772506,0.053666275727724394,4.6601579793555
Cambodia,Brazil,0,0,0,13,28,33,35,35,1,0,0,7,0.25,2,0.06060606060606061,KHM,BRA,12118841,14363532,15417523,16396860,175873720,196353492,205188205,213196304,0.2134555030658309,0.016416794917795574
China,Faroe Islands,1,0,1,7,18,30,35,34,34,0,0,17,0.9444444444444444,5,0.16666666666666666,CHN,FRO,1262645000,1337705000,1379860000,1411100000,45660,48410,48816,52415,0.0024803344908227625,66.77477821234379
Ghana,Philippines,8,10,11,8,34,34,35,27,3.375,3,0.2727272727272727,1,0.029411764705882353,1,0.029411764705882353,GHA,PHL,19665502,25574719,28870939,32180401,77958223,94636700,103031365,112190977,0.10876185166244509,0.031196804712735497
Guatemala,Philippines,9,12,276,223,34,34,35,26,2.888888888888889,267,0.967391304347826,1,0.029411764705882353,1,0.029411764705882353,GTM,PHL,11589761,14259687,15567419,16858333,77958223,94636700,103031365,112190977,0.2076124608524461,0.031196804712735497
Laos,Czechia,2,3,4,16,27,25,35,33,16.5,2,0.5,8,0.2962962962962963,10,0.4,LAO,CZE,5430853,6323418,6787419,7319399,10255063,10474410,10546059,10697858,0.47818133701961046,0.32716829855098095
Malaysia,Ecuador,12,14,15,18,28,34,35,23,1.9166666666666667,3,0.2,7,0.25,1,0.029411764705882353,MYS,ECU,22945150,28717731,31068833,33199993,12626507,14989585,16195902,17588595,0.10542170897445673,0.19899258582052745
Maldives,Italy,1,6,11,23,83,33,35,34,34,10,0.9090909090909091,-48,-0.5783132530120482,2,0.06060606060606061,MDV,ITA,282507,361575,435582,514438,56942108,59277417,60730582,59438851,6.803540951484922,0.05888404538640896
Palau,Philippines,3,4,1186,959,34,34,35,32,10.666666666666666,1183,0.9974704890387859,1,0.029411764705882353,1,0.029411764705882353,PLW,PHL,19726,18540,17794,17972,77958223,94636700,103031365,112190977,194.7473848208324,0.031196804712735497
South Korea,Namibia,52,49,48,37,35,34,35,-17,-0.3269230769230769,-4,-0.08333333333333333,0,0,1,0.029411764705882353,KOR,NAM,47008111,49554112,51014947,51836239,1819141,2099271,2282704,2489098,0.06752033070917819,1.406131859814278
Timor-Leste,Austria,0,0,0,0,0,35,35,35,1,0,0,35,1,0,0,TLS,AUT,878360,1088486,1205813,1299995,8011566,8363404,8642699,8916864,2.692318047377105,0.39251467780600896
Indonesia,Bahamas,8,7,6,18,30,33,34,26,3.25,-2,-0.3333333333333333,4,0.13333333333333333,1,0.030303030303030304,IDN,BHS,214072421,244016173,259091970,271857970,325014,373272,392697,406471,0.012506530524008547,8.364680383102362
Laos,South Africa,33,20,14,17,24,30,34,1,0.030303030303030304,-19,-1.3571428571428572,10,0.4166666666666667,4,0.13333333333333333,LAO,ZAF,5430853,6323418,6787419,7319399,46813266,51784921,55876504,58801927,0.46451901310476446,0.05782123432791581
Myanmar,Bhutan,16,19,22,27,32,34,34,18,1.125,6,0.2727272727272727,2,0.0625,0,0,MMR,BTN,45538332,49390988,51483949,53423198,587207,705516,743274,772506,0.06364276432870979,4.40126031383575
Spain,Sri Lanka,0,3,8,17,36,35,34,34,1,8,1,-2,-0.05555555555555555,-1,-0.02857142857142857,ESP,LKA,40567864,46576897,46444832,47365655,18776371,20668557,21336697,21919000,0.0717819694460047,0.15511656553674893
Cambodia,Poland,31,26,23,24,27,25,33,2,0.06451612903225806,-8,-0.34782608695652173,6,0.2222222222222222,8,0.32,KHM,POL,12118841,14363532,15417523,16396860,38258629,38042794,37986412,37899070,0.20125804574778344,0.08707337673457423
Democratic Republic of the Congo,Philippines,1,1,2,1,32,32,33,32,32,1,0.5,1,0.03125,1,0.03125,COD,PHL,48616317,66391257,78656904,92853164,77958223,94636700,103031365,112190977,0.035539984399454605,0.02941413015772204
Malaysia,Panama,12,17,24,22,25,28,33,21,1.75,12,0.5,8,0.32,5,0.17857142857142858,MYS,PAN,22945150,28717731,31068833,33199993,3001731,3623617,3957099,4294396,0.09939761131877346,0.7684433387139891
North Korea,Greece,541,274,11,23,36,33,33,-508,-0.9390018484288355,-530,-48.18181818181818,-3,-0.08333333333333333,0,0,PRK,GRC,23367059,24686435,25258015,25867467,10805808,11121341,10820883,10698599,0.12757337237542432,0.30845160193404764
South Korea,Bhutan,15,18,21,26,31,33,33,18,1.2,6,0.2857142857142857,2,0.06451612903225806,0,0,KOR,BTN,47008111,49554112,51014947,51836239,587207,705516,743274,772506,0.06366202609722516,4.271811481075876
South Korea,Latvia,9,13,18,27,37,30,33,24,2.6666666666666665,9,0.5,-4,-0.10810810810810811,3,0.1,KOR,LVA,47008111,49554112,51014947,51836239,2367550,2097555,1977527,1900449,0.06366202609722516,1.7364317590211578
Sri Lanka,Bhutan,15,18,21,26,31,33,33,18,1.2,6,0.2857142857142857,2,0.06451612903225806,0,0,LKA,BTN,18776371,20668557,21336697,21919000,587207,705516,743274,772506,0.15055431360919752,4.271811481075876
Bangladesh,Namibia,48,45,44,34,32,31,32,-16,-0.3333333333333333,-4,-0.09090909090909091,0,0,1,0.03225806451612903,BGD,NAM,129193327,148391139,157830000,167420951,1819141,2099271,2282704,2489098,0.019113497927747407,1.285606271830197
Fiji,Denmark,13,17,21,23,24,23,32,19,1.4615384615384615,8,0.38095238095238093,8,0.3333333333333333,9,0.391304347826087,FJI,DNK,832509,905169,917200,920422,5339616,5547683,5683483,5831404,3.4766661379236914,0.5487529246816032
New Caledonia,Solomon Islands,129,128,122,76,36,33,32,-97,-0.751937984496124,-7,-0.05737704918032787,-4,-0.1111111111111111,-1,-0.030303030303030304,NCL,SLB,213230,249750,269460,271080,429978,540394,612660,691191,11.804633318577542,4.62968991205036
Portugal,Sri Lanka,0,0,2,6,13,33,32,32,1,2,1,19,1.4615384615384615,-1,-0.030303030303030304,PRT,LKA,10289898,10573100,10358076,10297081,18776371,20668557,21336697,21919000,0.31076768260830423,0.14599206168164605
Indonesia,Serbia,3,24,33,33,33,32,31,28,9.333333333333334,30,0.9090909090909091,-2,-0.06060606060606061,-1,-0.03125,IDN,SRB,214072421,244016173,259091970,271857970,7516346,7291436,7095383,6899126,0.011403013124831322,0.44933227774068774
Iran,Dominican Republic,70,78,85,57,30,30,31,-39,-0.5571428571428572,15,0.17647058823529413,1,0.03333333333333333,1,0.03333333333333333,IRN,DOM,65544383,75373855,81790841,87290193,8540791,9775755,10405832,10999664,0.0355137260379296,0.28182679034559605
Malaysia,Venezuela (Bolivarian Republic of),30,29,29,30,32,34,31,1,0.03333333333333333,-1,-0.034482758620689655,-1,-0.03125,-3,-0.08823529411764706,MYS,VEN,22945150,28717731,31068833,33199993,24427729,28715022,30529716,28490453,0.09337351366309023,0.10880837872251452
Myanmar,Hungary,8,7,6,7,8,13,31,23,2.875,-2,-0.3333333333333333,23,2.875,18,1.3846153846153846,MMR,HUN,45538332,49390988,51483949,53423198,10210971,10000023,9843028,9750149,0.058027226299705977,0.31794385911435813
North Korea,Cyprus,8,12,15,23,35,31,31,23,2.875,7,0.4666666666666667,-4,-0.11428571428571428,0,0,PRK,CYP,23367059,24686435,25258015,25867467,948237,1129686,1187280,1237537,0.11984165283751982,2.50497560881008
Bangladesh,Bolivia (Plurinational State of),5,11,16,20,24,29,30,25,5,11,0.6875,6,0.25,1,0.034482758620689655,BGD,BOL,129193327,148391139,157830000,167420951,8592656,10223270,11090085,11936162,0.017918904307263193,0.2513370713299635
Bhutan,Italy,12,24,36,36,33,39,30,18,1.5,24,0.6666666666666666,-3,-0.09090909090909091,-9,-0.23076923076923078,BTN,ITA,587207,705516,743274,772506,56942108,59277417,60730582,59438851,3.8834649827962497,0.05047203890263626
Fiji,French Polynesia,27,29,32,33,32,30,30,3,0.1111111111111111,5,0.15625,-2,-0.0625,0,0,FJI,PYF,832509,905169,917200,920422,250927,283788,291787,301920,3.259374504303461,9.936406995230525
France,Bhutan,14,17,19,24,29,30,30,16,1.1428571428571428,5,0.2631578947368421,1,0.034482758620689655,0,0,FRA,BTN,60921384,65030575,66548272,67571107,587207,705516,743274,772506,0.044397674289989066,3.8834649827962497
India,Georgia,0,0,32,30,30,31,30,30,1,32,1,0,0,-1,-0.03225806451612903,IND,GEO,1059633675,1240613620,1322866505,1396387127,4077131,3786695,3725276,3722716,0.0021484013580425967,0.8058632460816242
Iran,Namibia,45,43,41,32,30,29,30,-15,-0.3333333333333333,-4,-0.0975609756097561,0,0,1,0.034482758620689655,IRN,NAM,65544383,75373855,81790841,87290193,1819141,2099271,2282704,2489098,0.034368121972189934,1.2052558798408097
Netherlands,Cambodia,14,37,59,46,33,30,30,16,1.1428571428571428,45,0.7627118644067796,-3,-0.09090909090909091,0,0,NLD,KHM,15925513,16615394,16939923,17441500,12118841,14363532,15417523,16396860,0.1720035547401313,0.1829618597707122
Philippines,Ghana,20,20,22,31,23,28,30,10,0.5,2,0.09090909090909091,7,0.30434782608695654,2,0.07142857142857142,PHL,GHA,77958223,94636700,103031365,112190977,19665502,25574719,28870939,32180401,0.02674011832520186,0.0932244442820958
Russian Federation,Cambodia,14,37,59,46,33,30,30,16,1.1428571428571428,45,0.7627118644067796,-3,-0.09090909090909091,0,0,RUS,KHM,146596869,142849468,144640716,145245148,12118841,14363532,15417523,16396860,0.020654734711000468,0.1829618597707122
South Korea,Solomon Islands,38,38,37,34,34,31,30,-8,-0.21052631578947367,-1,-0.02702702702702703,-4,-0.11764705882352941,-1,-0.03225806451612903,KOR,SLB,47008111,49554112,51014947,51836239,429978,540394,612660,691191,0.05787456917929559,4.340334292547213
Tonga,Vanuatu,24,25,27,27,29,30,30,6,0.25,3,0.1111111111111111,1,0.034482758620689655,0,0,TON,VUT,102603,107383,106122,105254,192074,245453,276438,311685,28.50247971573527,9.625102266711583
Pakistan,Bermuda,13,18,19,18,17,26,29,16,1.2307692307692308,6,0.3157894736842105,12,0.7058823529411765,3,0.11538461538461539,PAK,BMU,154369924,194454498,210969298,227196741,61833,65124,65237,63893,0.012764267600123719,45.388383704005136
Papua New Guinea,Sweden,18,21,23,25,24,31,29,11,0.6111111111111112,5,0.21739130434782608,5,0.20833333333333334,-2,-0.06451612903225806,PNG,SWE,5508297,7583269,8682174,9749640,8872109,9378126,9799186,10353442,0.29744688008993153,0.28010008652195084
Thailand,Latvia,1,1,2,7,13,8,29,28,28,1,0.5,16,1.2307692307692308,21,2.625,THA,LVA,63066603,68270489,70294397,71475664,2367550,2097555,1977527,1900449,0.04057325021842399,1.5259551821701083
Japan,Solomon Islands,101,100,96,61,31,29,28,-73,-0.7227722772277227,-5,-0.052083333333333336,-3,-0.0967741935483871,-1,-0.034482758620689655,JPN,SLB,126843000,128070000,127141000,126261000,429978,540394,612660,691191,0.02217628563055892,4.050978673044064
Maldives,Egypt,4,12,21,25,27,19,28,24,6,17,0.8095238095238095,1,0.037037037037037035,9,0.47368421052631576,MDV,EGY,282507,361575,435582,514438,71371371,87252413,97723799,107465134,5.442832761187937,0.02605496216102983
Papua New Guinea,Belgium,99,99,99,99,33,35,28,-71,-0.7171717171717171,0,0,-5,-0.15151515151515152,-7,-0.2,PNG,BEL,5508297,7583269,8682174,9749640,10251250,10895586,11274196,11538604,0.2871900911213132,0.24266367057921392
Papua New Guinea,France,108,112,115,50,25,27,28,-80,-0.7407407407407407,7,0.06086956521739131,3,0.12,1,0.037037037037037035,PNG,FRA,5508297,7583269,8682174,9749640,60921384,65030575,66548272,67571107,0.2871900911213132,0.04143782933732312
United States of America,Solomon Islands,135,134,128,77,31,29,28,-107,-0.7925925925925926,-7,-0.0546875,-3,-0.0967741935483871,-1,-0.034482758620689655,USA,SLB,282162411,309327143,320738994,331526933,429978,540394,612660,691191,0.00844576932155313,4.050978673044064
Australia,Bhutan,12,15,17,21,25,27,27,15,1.25,5,0.29411764705882354,2,0.08,0,0,AUS,BTN,19028802,22031750,23815995,25649248,587207,705516,743274,772506,0.10526624406298382,3.495118484516625
Cuba,Timor-Leste,85,92,101,107,110,29,27,-58,-0.6823529411764706,16,0.15841584158415842,-83,-0.7545454545454545,-2,-0.06896551724137931,CUB,TLS,11105791,11290417,11339894,11300698,878360,1088486,1205813,1299995,0.23892329482656735,2.076931065119481
Germany,Bhutan,12,15,17,21,25,27,27,15,1.25,5,0.29411764705882354,2,0.08,0,0,DEU,BTN,82211508,81776930,81686611,83160871,587207,705516,743274,772506,0.0324671924131242,3.495118484516625
India,Dominica,10,13,15,19,24,28,27,17,1.7,5,0.3333333333333333,3,0.125,-1,-0.03571428571428571,IND,DMA,1059633675,1240613620,1322866505,1396387127,68346,68755,70007,71995,0.001933561222238337,37.502604347524134
India,Liechtenstein,0,0,0,11,23,27,27,27,1,0,0,4,0.17391304347826086,0,0,IND,LIE,1059633675,1240613620,1322866505,1396387127,33026,35926,37355,38756,0.001933561222238337,69.66663226339148
Mongolia,Georgia,0,0,29,27,27,28,27,27,1,29,1,0,0,-1,-0.03571428571428571,MNG,GEO,2450979,2702520,2964749,3294335,4077131,3786695,3725276,3722716,0.8195887789189624,0.7252769214734619
Nepal,Slovenia,0,0,5,9,12,14,27,27,1,5,1,15,1.25,13,0.9285714285714286,NPL,SVN,24559500,27161567,27610325,29348627,1988925,2048583,2063531,2102419,0.09199748935444237,1.2842349693377009
South Korea,Belarus,22,26,29,28,27,29,27,5,0.22727272727272727,7,0.2413793103448276,0,0,-2,-0.06896551724137931,KOR,BLR,47008111,49554112,51014947,51836239,9979610,9483836,9461076,9379952,0.052087112261366024,0.2878479548722637
United Republic of Tanzania,Papua New Guinea,38,38,28,34,28,28,27,-11,-0.2894736842105263,-10,-0.35714285714285715,-1,-0.03571428571428571,-1,-0.03571428571428571,TZA,PNG,34463704,45110527,52542823,61704518,5508297,7583269,8682174,9749640,0.04375692554635951,0.27693330215269485
Vietnam,Puerto Rico,124,130,138,108,65,64,27,-97,-0.782258064516129,14,0.10144927536231885,-38,-0.5846153846153846,-37,-0.578125,VNM,PRI,79001142,87411012,92191398,96648685,3810605,3721525,3473232,3281557,0.027936231103403014,0.822780161977988
Hong Kong,Bahamas,46,35,25,25,24,26,26,-20,-0.43478260869565216,-21,-0.84,2,0.08333333333333333,0,0,HKG,BHS,6665000,7024200,7291300,7481000,325014,373272,392697,406471,0.3475471193690683,6.39652029296063
Pakistan,Guatemala,17,17,16,20,23,25,26,9,0.5294117647058824,-1,-0.0625,3,0.13043478260869565,1,0.04,PAK,GTM,154369924,194454498,210969298,227196741,11589761,14259687,15567419,16858333,0.011443826124248851,0.15422639949038852
Tonga,Papua New Guinea,40,40,29,33,27,27,26,-14,-0.35,-11,-0.3793103448275862,-1,-0.037037037037037035,-1,-0.037037037037037035,TON,PNG,102603,107383,106122,105254,5508297,7583269,8682174,9749640,24.702149086970564,0.26667651318407654
Fiji,Austria,10,11,12,13,14,26,25,15,1.5,2,0.16666666666666666,11,0.7857142857142857,-1,-0.038461538461538464,FJI,AUT,832509,905169,917200,920422,8011566,8363404,8642699,8916864,2.716145420252884,0.2803676270042921
Pakistan,Bolivia (Plurinational State of),55,42,29,25,20,24,25,-30,-0.5454545454545454,-26,-0.896551724137931,5,0.25,1,0.041666666666666664,PAK,BOL,154369924,194454498,210969298,227196741,8592656,10223270,11090085,11936162,0.011003678965623894,0.20944755944163626
Russian Federation,Papua New Guinea,41,42,31,31,26,26,25,-16,-0.3902439024390244,-10,-0.3225806451612903,-1,-0.038461538461538464,-1,-0.038461538461538464,RUS,PNG,146596869,142849468,144640716,145245148,5508297,7583269,8682174,9749640,0.017212278925833723,0.2564197242154582
South Korea,Serbia,2,19,27,27,27,26,25,23,11.5,25,0.9259259259259259,-2,-0.07407407407407407,-1,-0.038461538461538464,KOR,SRB,47008111,49554112,51014947,51836239,7516346,7291436,7095383,6899126,0.04822880764941299,0.3623647401134579
Fiji,Belgium,15,15,15,18,25,26,24,9,0.6,0,0,-1,-0.04,-2,-0.07692307692307693,FJI,BEL,832509,905169,917200,920422,10251250,10895586,11274196,11538604,2.607499603442769,0.2079974319250405
India,Nicaragua,12,10,15,22,23,24,24,12,1,3,0.2,1,0.043478260869565216,0,0,IND,NIC,1059633675,1240613620,1322866505,1396387127,5123222,5855734,6298598,6755895,0.0017187210864340772,0.3552453079865806
Maldives,Sweden,5,6,7,13,11,21,24,19,3.8,2,0.2857142857142857,13,1.1818181818181819,3,0.14285714285714285,MDV,SWE,282507,361575,435582,514438,8872109,9378126,9799186,10353442,4.665285223875375,0.23180696815609725
New Zealand,Bhutan,11,13,15,19,23,24,24,13,1.1818181818181819,4,0.26666666666666666,1,0.043478260869565216,0,0,NZL,BTN,3857700,4350700,4609400,5090200,587207,705516,743274,772506,0.47149424384110644,3.1067719862370002
Seychelles,Sri Lanka,0,2,5,12,26,25,24,24,1,5,1,-2,-0.07692307692307693,-1,-0.04,SYC,LKA,81131,89770,93419,98462,18776371,20668557,21336697,21919000,24.37488574272308,0.10949404626123455
Sri Lanka,Slovakia,0,0,0,0,0,15,24,24,1,0,0,24,1,9,0.6,LKA,SVK,18776371,20668557,21336697,21919000,5388720,5391428,5423801,5458827,0.10949404626123455,0.4396548928918245
Switzerland,Bhutan,11,13,15,19,23,24,24,13,1.1818181818181819,4,0.26666666666666666,1,0.043478260869565216,0,0,CHE,BTN,7184250,7824909,8282396,8638167,587207,705516,743274,772506,0.27783672161003603,3.1067719862370002
Vietnam,Slovenia,0,0,0,1,6,15,24,24,1,0,0,18,3,9,0.6,VNM,SVN,79001142,87411012,92191398,96648685,1988925,2048583,2063531,2102419,0.024832205425247122,1.1415421949668454
Austria,Maldives,50,36,21,17,20,23,23,-27,-0.54,-29,-1.380952380952381,3,0.15,0,0,AUT,MDV,8011566,8363404,8642699,8916864,282507,361575,435582,514438,0.25793821684394874,4.470898339547234
Bhutan,Austria,14,16,18,19,20,25,23,9,0.6428571428571429,4,0.2222222222222222,3,0.15,-2,-0.08,BTN,AUT,587207,705516,743274,772506,8011566,8363404,8642699,8916864,2.9773231534771254,0.25793821684394874
Bhutan,Bulgaria,1,7,13,20,27,21,23,22,22,12,0.9230769230769231,-4,-0.14814814814814814,2,0.09523809523809523,BTN,BGR,587207,705516,743274,772506,8170172,7395599,7177991,6934015,2.9773231534771254,0.33169815756095133
China,Cabo Verde,30,41,51,37,22,23,23,-7,-0.23333333333333334,21,0.4117647058823529,1,0.045454545454545456,0,0,CHN,CPV,1262645000,1337705000,1379860000,1411100000,458251,521212,552166,582640,0.0016299340939692438,3.9475490869147327
Indonesia,Croatia,0,0,0,14,27,27,23,23,1,0,0,-4,-0.14814814814814814,-4,-0.14814814814814814,IDN,HRV,214072421,244016173,259091970,271857970,4468302,4295427,4203604,4047680,0.008460300060358722,0.5682267372914855
Malaysia,Slovakia,0,0,0,0,0,18,23,23,1,0,0,23,1,5,0.2777777777777778,MYS,SVK,22945150,28717731,31068833,33199993,5388720,5391428,5423801,5458827,0.06927712304035727,0.4213359390213319
Myanmar,Jordan,2,16,29,22,46,19,23,21,10.5,27,0.9310344827586207,-23,-0.5,4,0.21052631578947367,MMR,JOR,45538332,49390988,51483949,53423198,5056174,6931258,9494246,10928721,0.043052458222362505,0.21045463599994912
Pakistan,Seychelles,23,17,11,16,22,24,23,0,0,-12,-1.0909090909090908,1,0.045454545454545456,-1,-0.041666666666666664,PAK,SYC,154369924,194454498,210969298,227196741,81131,89770,93419,98462,0.010123384648373984,23.359265503442952
South Korea,Croatia,0,0,0,14,27,27,23,23,1,0,0,-4,-0.14814814814814814,-4,-0.14814814814814814,KOR,HRV,47008111,49554112,51014947,51836239,4468302,4295427,4203604,4047680,0.04437050303745995,0.5682267372914855
Bangladesh,Malta,6,8,9,13,13,11,22,16,2.6666666666666665,3,0.3333333333333333,9,0.6923076923076923,11,1,BGD,MLT,129193327,148391139,157830000,167420951,390087,414508,445053,515332,0.01314052982532634,4.269092546164415
Hong Kong,Mauritius,91,45,25,21,20,23,22,-69,-0.7582417582417582,-66,-2.64,2,0.1,-1,-0.043478260869565216,HKG,MUS,6665000,7024200,7291300,7481000,1186873,1250400,1262879,1266014,0.29407833177382703,1.7377374973736468
Nepal,Guinea,0,0,0,0,0,25,22,22,1,0,0,22,1,-3,-0.12,NPL,GIN,24559500,27161567,27610325,29348627,8336967,10270728,11625998,13205153,0.07496091725176786,0.16660162892470842
Sweden,Bhutan,11,13,14,18,22,23,22,11,1,3,0.21428571428571427,0,0,-1,-0.043478260869565216,SWE,BTN,8872109,9378126,9799186,10353442,587207,705516,743274,772506,0.2124897208097558,2.84787432071725
Bangladesh,Slovakia,0,0,0,0,0,18,21,21,1,0,0,21,1,3,0.16666666666666666,BGD,SVK,129193327,148391139,157830000,167420951,5388720,5391428,5423801,5458827,0.012543233015084233,0.3846980312803465
India,Puerto Rico,96,101,108,84,51,49,21,-75,-0.78125,12,0.1111111111111111,-30,-0.5882352941176471,-28,-0.5714285714285714,IND,PRI,1059633675,1240613620,1322866505,1396387127,3810605,3721525,3473232,3281557,0.0015038809506298177,0.6399401259828794
Indonesia,Argentina,47,46,45,34,21,21,21,-26,-0.5531914893617021,-2,-0.044444444444444446,0,0,0,0,IDN,ARG,214072421,244016173,259091970,271857970,37070774,40788453,43131966,45376763,0.007724621794240573,0.046279193604003885
Italy,Mongolia,3,3,4,9,17,21,21,18,6,1,0.25,4,0.23529411764705882,0,0,ITA,MNG,56942108,59277417,60730582,59438851,2450979,2702520,2964749,3294335,0.03533042723184538,0.637457939159193
Mongolia,Iceland,5,8,10,18,25,20,21,16,3.2,5,0.5,-4,-0.16,1,0.05,MNG,ISL,2450979,2702520,2964749,3294335,281205,318041,330815,366463,0.637457939159193,5.730455734958236
Pakistan,Bhutan,10,12,14,17,20,22,21,11,1.1,4,0.2857142857142857,1,0.05,-1,-0.045454545454545456,PAK,BTN,154369924,194454498,210969298,227196741,587207,705516,743274,772506,0.009243090331124072,2.7184254879573753
Pakistan,Mongolia,12,13,15,15,17,21,21,9,0.75,3,0.2,4,0.23529411764705882,0,0,PAK,MNG,154369924,194454498,210969298,227196741,2450979,2702520,2964749,3294335,0.009243090331124072,0.637457939159193
Philippines,Saint Lucia,14,14,27,27,25,23,21,7,0.5,13,0.48148148148148145,-4,-0.16,-2,-0.08695652173913043,PHL,LCA,77958223,94636700,103031365,112190977,159500,170935,175623,179237,0.0187180828276413,11.716330891501197
Sri Lanka,Ghana,15,15,17,24,17,20,21,6,0.4,2,0.11764705882352941,4,0.23529411764705882,1,0.05,LKA,GHA,18776371,20668557,21336697,21919000,19665502,25574719,28870939,32180401,0.09580729047858023,0.06525711099746706
Switzerland,Mongolia,4,4,5,10,17,21,21,17,4.25,1,0.2,4,0.23529411764705882,0,0,CHE,MNG,7184250,7824909,8282396,8638167,2450979,2702520,2964749,3294335,0.2431071314087815,0.637457939159193
Vanuatu,Italy,1,2,3,13,19,21,21,20,20,2,0.6666666666666666,2,0.10526315789473684,0,0,VUT,ITA,192074,245453,276438,311685,56942108,59277417,60730582,59438851,6.737571586698109,0.03533042723184538
Bangladesh,Slovenia,0,0,3,0,3,3,20,20,1,3,1,17,5.666666666666667,17,5.666666666666667,BGD,SVN,129193327,148391139,157830000,167420951,1988925,2048583,2063531,2102419,0.011945936204842127,0.9512851624723712
Cambodia,Argentina,46,45,44,33,20,20,20,-26,-0.5652173913043478,-2,-0.045454545454545456,0,0,0,0,KHM,ARG,12118841,14363532,15417523,16396860,37070774,40788453,43131966,45376763,0.12197457318047479,0.0440754224800037
Hong Kong,Micronesia (Fed. States of),8,7,8,15,18,21,20,12,1.5,0,0,2,0.1111111111111111,-1,-0.047619047619047616,HKG,FSM,6665000,7024200,7291300,7481000,111709,107588,109462,112106,0.2673439379762064,17.840258326940575
Indonesia,Costa Rica,13,10,13,10,18,17,20,7,0.5384615384615384,0,0,2,0.1111111111111111,3,0.17647058823529413,IDN,CRI,214072421,244016173,259091970,271857970,3979193,4622252,4895242,5123105,0.0073567826611814985,0.3903882508752017
Malaysia,Bulgaria,0,1,1,2,2,3,20,20,1,1,1,18,9,17,5.666666666666667,MYS,BGR,22945150,28717731,31068833,33199993,8170172,7395599,7177991,6934015,0.06024097655683241,0.28843318048778377
North Korea,Romania,0,0,0,0,0,7,20,20,1,0,0,20,1,13,1.8571428571428572,PRK,ROU,23367059,24686435,25258015,25867467,22442971,20246871,19815616,19265250,0.07731719537904504,0.10381386174588962
Sri Lanka,Bulgaria,2,4,5,7,9,12,20,18,9,3,0.6,11,1.2222222222222223,8,0.6666666666666666,LKA,BGR,18776371,20668557,21336697,21919000,8170172,7395599,7177991,6934015,0.09124503855102879,0.28843318048778377
Thailand,Lithuania,0,0,0,0,0,2,20,20,1,0,0,20,1,18,9,THA,LTU,63066603,68270489,70294397,71475664,3499536,3097282,2904910,2794885,0.02798155187477517,0.7155929492626709
Cambodia,Greece,8,9,10,16,22,20,19,11,1.375,2,0.2,-3,-0.13636363636363635,-1,-0.05,KHM,GRC,12118841,14363532,15417523,16396860,10805808,11121341,10820883,10698599,0.11587584452145107,0.177593346568088
Malaysia,Cayman Islands,5,11,19,18,18,18,19,14,2.8,14,0.7368421052631579,1,0.05555555555555555,1,0.05555555555555555,MYS,CYM,22945150,28717731,31068833,33199993,39658,54074,60911,67311,0.05722892772899079,28.227184264087594
Maldives,Netherlands,0,0,0,0,9,11,19,19,1,0,0,10,1.1111111111111112,8,0.7272727272727273,MDV,NLD,282507,361575,435582,514438,15925513,16615394,16939923,17441500,3.6933508022346717,0.10893558466874981
Netherlands,Bhutan,9,11,13,16,19,20,19,10,1.1111111111111112,4,0.3076923076923077,0,0,-1,-0.05,NLD,BTN,15925513,16615394,16939923,17441500,587207,705516,743274,772506,0.10893558466874981,2.459527822437625
Philippines,El Salvador,31,24,17,18,18,19,19,-12,-0.3870967741935484,-14,-0.8235294117647058,1,0.05555555555555555,0,0,PHL,SLV,77958223,94636700,103031365,112190977,5958482,6114034,6231066,6292731,0.016935408272627843,0.3019356778479805
Sri Lanka,Slovenia,0,0,7,6,10,17,19,19,1,7,1,9,0.9,2,0.11764705882352941,LKA,SVN,18776371,20668557,21336697,21919000,1988925,2048583,2063531,2102419,0.08668278662347735,0.9037209043487525
Czechia,Mongolia,7,6,7,10,15,18,18,11,1.5714285714285714,0,0,3,0.2,0,0,CZE,MNG,10255063,10474410,10546059,10697858,2450979,2702520,2964749,3294335,0.16825798211193305,0.5463925192793082
Iran,El Salvador,20,17,14,16,17,18,18,-2,-0.1,-6,-0.42857142857142855,1,0.058823529411764705,0,0,IRN,SLV,65544383,75373855,81790841,87290193,5958482,6114034,6231066,6292731,0.020620873183313963,0.2860443263822973
Iran,Guatemala,12,12,12,14,16,18,18,6,0.5,0,0,2,0.125,0,0,IRN,GTM,65544383,75373855,81790841,87290193,11589761,14259687,15567419,16858333,0.020620873183313963,0.10677212272411513
Mongolia,Costa Rica,7,7,11,8,16,15,18,11,1.5714285714285714,4,0.36363636363636365,2,0.125,3,0.2,MNG,CRI,2450979,2702520,2964749,3294335,3979193,4622252,4895242,5123105,0.5463925192793082,0.35134942578768147
Philippines,Bhutan,9,10,12,15,18,19,18,9,1,3,0.25,0,0,-1,-0.05263157894736842,PHL,BTN,77958223,94636700,103031365,112190977,587207,705516,743274,772506,0.016044070995121115,2.33007898967775
Timor-Leste,Switzerland,0,0,0,0,0,14,18,18,1,0,0,18,1,4,0.2857142857142857,TLS,CHE,878360,1088486,1205813,1299995,7184250,7824909,8282396,8638167,1.3846207100796541,0.20837754120752702
Indonesia,French Polynesia,15,16,18,18,18,17,17,2,0.13333333333333333,3,0.16666666666666666,-1,-0.05555555555555555,0,0,IDN,PYF,214072421,244016173,259091970,271857970,250927,283788,291787,301920,0.006253265262004273,5.63063063063063
Malaysia,Dominican Republic,36,40,44,31,18,17,17,-19,-0.5277777777777778,8,0.18181818181818182,-1,-0.05555555555555555,0,0,MYS,DOM,22945150,28717731,31068833,33199993,8540791,9775755,10405832,10999664,0.05120483007330755,0.1545501753508107
Malaysia,Estonia,0,0,0,0,2,8,17,17,1,0,0,15,7.5,9,1.125,MYS,EST,22945150,28717731,31068833,33199993,1396985,1331475,1315407,1329522,0.05120483007330755,1.2786550354187445
New Zealand,Maldives,6,8,10,13,15,17,17,11,1.8333333333333333,4,0.4,2,0.13333333333333333,0,0,NZL,MDV,3857700,4350700,4609400,5090200,282507,361575,435582,514438,0.33397508938745035,3.3045770335783904
North Korea,Hungary,0,0,0,0,0,16,17,17,1,0,0,17,1,1,0.0625,PRK,HUN,23367059,24686435,25258015,25867467,10210971,10000023,9843028,9750149,0.06571961607218829,0.1743563098369061
Pakistan,Guinea,0,0,0,0,0,19,17,17,1,0,0,17,1,-2,-0.10526315789473684,PAK,GIN,154369924,194454498,210969298,227196741,8336967,10270728,11625998,13205153,0.007482501696624249,0.12873762235091105
Singapore,Bhutan,8,10,11,14,17,18,17,9,1.125,3,0.2727272727272727,0,0,-1,-0.05555555555555555,SGP,BTN,4027887,5076732,5535002,5685807,587207,705516,743274,772506,0.2989900993825503,2.200630156917875
Côte d'Ivoire,Thailand,0,0,2,8,15,16,16,16,1,2,1,1,0.06666666666666667,0,0,CIV,THA,16799670,21120042,23596741,26811790,63066603,68270489,70294397,71475664,0.059675239885140084,0.022385241499820133
Democratic Republic of the Congo,Thailand,0,0,2,8,15,16,16,16,1,2,1,1,0.06666666666666667,0,0,COD,THA,48616317,66391257,78656904,92853164,63066603,68270489,70294397,71475664,0.017231507587614353,0.022385241499820133
Nepal,Bulgaria,1,2,3,4,5,8,16,15,15,2,0.6666666666666666,11,2.2,8,1,NPL,BGR,24559500,27161567,27610325,29348627,8170172,7395599,7177991,6934015,0.054517030728558444,0.23074654439022702
Nepal,Georgia,0,0,18,17,17,17,16,16,1,18,1,-1,-0.058823529411764705,-1,-0.058823529411764705,NPL,GEO,24559500,27161567,27610325,29348627,4077131,3786695,3725276,3722716,0.054517030728558444,0.429793731243533
Solomon Islands,Switzerland,0,0,0,0,0,19,16,16,1,0,0,16,1,-3,-0.15789473684210525,SLB,CHE,429978,540394,612660,691191,7184250,7824909,8282396,8638167,2.31484495602518,0.18522448107335734
Austria,Mongolia,3,3,4,8,13,16,15,12,4,1,0.25,2,0.15384615384615385,-1,-0.0625,AUT,MNG,8011566,8363404,8642699,8916864,2450979,2702520,2964749,3294335,0.16822057620257524,0.45532709939942356
Bangladesh,Latvia,3,4,5,6,8,5,15,12,4,2,0.4,7,0.875,10,2,BGD,LVA,129193327,148391139,157830000,167420951,2367550,2097555,1977527,1900449,0.008959452153631597,0.7892871631914352
Bulgaria,Mongolia,2,1,2,7,13,16,15,13,6.5,0,0,2,0.15384615384615385,-1,-0.0625,BGR,MNG,8170172,7395599,7177991,6934015,2450979,2702520,2964749,3294335,0.21632488536583783,0.45532709939942356
Maldives,Romania,0,0,0,0,0,6,15,15,1,0,0,15,1,9,1.5,MDV,ROU,282507,361575,435582,514438,22442971,20246871,19815616,19265250,2.9158032649221095,0.07786039630941723
Nepal,Lithuania,0,0,0,0,0,12,15,15,1,0,0,15,1,3,0.25,NPL,LTU,24559500,27161567,27610325,29348627,3499536,3097282,2904910,2794885,0.051109716308023544,0.5366947119470031
North Korea,Luxembourg,0,0,0,0,0,0,15,15,1,0,0,15,1,15,1,PRK,LUX,23367059,24686435,25258015,25867467,436300,506953,569604,630419,0.057987896534283774,2.3793699111226028
State of Palestine,Thailand,0,1,3,8,14,15,15,15,1,3,1,1,0.07142857142857142,0,0,PSE,THA,2922153,3786161,4270092,4803269,63066603,68270489,70294397,71475664,0.312287319323569,0.020986163906081375
Vanuatu,Bulgaria,0,0,0,1,1,15,15,15,1,0,0,14,14,0,0,VUT,BGR,192074,245453,276438,311685,8170172,7395599,7177991,6934015,4.812551133355791,0.21632488536583783
Cambodia,Romania,0,0,0,0,0,3,14,14,1,0,0,14,1,11,3.6666666666666665,KHM,ROU,12118841,14363532,15417523,16396860,22442971,20246871,19815616,19265250,0.08538220122633236,0.07266970322212273
Fiji,Ireland,3,8,17,17,14,14,14,11,3.6666666666666665,14,0.8235294117647058,0,0,0,0,FJI,IRL,832509,905169,917200,920422,3805174,4560155,4701957,4985382,1.521041435341615,0.2808210082998655
Italy,Cambodia,7,19,30,23,17,15,14,7,1,23,0.7666666666666667,-3,-0.17647058823529413,-1,-0.06666666666666667,ITA,KHM,56942108,59277417,60730582,59438851,12118841,14363532,15417523,16396860,0.023553618154563586,0.08538220122633236
Maldives,Austria,5,6,6,6,7,13,14,9,1.8,1,0.16666666666666666,7,1,1,0.07692307692307693,MDV,AUT,282507,361575,435582,514438,8011566,8363404,8642699,8916864,2.7214163805939684,0.15700587112240355
Mongolia,Egypt,1,6,11,13,14,10,14,13,13,10,0.9090909090909091,0,0,4,0.4,MNG,EGY,2450979,2702520,2964749,3294335,71371371,87252413,97723799,107465134,0.424971959439462,0.013027481080514915
Myanmar,Brazil,0,0,0,0,13,14,14,14,1,0,0,1,0.07692307692307693,0,0,MMR,BRA,45538332,49390988,51483949,53423198,175873720,196353492,205188205,213196304,0.02620584413535109,0.006566717967118229
Myanmar,Costa Rica,10,8,9,7,13,12,14,4,0.4,-1,-0.1111111111111111,1,0.07692307692307693,2,0.16666666666666666,MMR,CRI,45538332,49390988,51483949,53423198,3979193,4622252,4895242,5123105,0.02620584413535109,0.27327177561264115
North Korea,Argentina,31,30,29,23,14,14,14,-17,-0.5483870967741935,-2,-0.06896551724137931,0,0,0,0,PRK,ARG,23367059,24686435,25258015,25867467,37070774,40788453,43131966,45376763,0.05412203676533152,0.030852795736002588
North Korea,Slovakia,0,0,0,0,0,16,14,14,1,0,0,14,1,-2,-0.125,PRK,SVK,23367059,24686435,25258015,25867467,5388720,5391428,5423801,5458827,0.05412203676533152,0.2564653541868977
Papua New Guinea,Czechia,0,1,1,2,3,5,14,14,1,1,1,11,3.6666666666666665,9,1.8,PNG,CZE,5508297,7583269,8682174,9749640,10255063,10474410,10546059,10697858,0.1435950455606566,0.1308673194203924
Papua New Guinea,Guinea,0,0,0,0,0,16,14,14,1,0,0,14,1,-2,-0.125,PNG,GIN,5508297,7583269,8682174,9749640,8336967,10270728,11625998,13205153,0.1435950455606566,0.10601921840663263
Vietnam,Yemen,706,0,9,0,28,15,14,-692,-0.9801699716713881,-697,-77.44444444444444,-14,-0.5,-1,-0.06666666666666667,VNM,YEM,79001142,87411012,92191398,96648685,18628700,24743946,28516545,32284046,0.014485453164727487,0.04336507264300144
Cambodia,Bulgaria,6,8,9,11,13,11,13,7,1.1666666666666667,3,0.3333333333333333,0,0,2,0.18181818181818182,KHM,BGR,12118841,14363532,15417523,16396860,8170172,7395599,7177991,6934015,0.07928347256730862,0.18748156731705945
Iran,Liechtenstein,0,0,0,0,8,11,13,13,1,0,0,5,0.625,2,0.18181818181818182,IRN,LIE,65544383,75373855,81790841,87290193,33026,35926,37355,38756,0.014892852854615638,33.543193312003304
Iran,Thailand,0,9,21,16,13,13,13,13,1,21,1,0,0,0,0,IRN,THA,65544383,75373855,81790841,87290193,63066603,68270489,70294397,71475664,0.014892852854615638,0.01818800871860386
Malaysia,Slovenia,0,0,2,2,10,8,13,13,1,2,1,3,0.3,5,0.625,MYS,SVN,22945150,28717731,31068833,33199993,1988925,2048583,2063531,2102419,0.03915663476194106,0.6183353556070412
Papua New Guinea,Ireland,3,7,15,15,13,13,13,10,3.3333333333333335,12,0.8,0,0,0,0,PNG,IRL,5508297,7583269,8682174,9749640,3805174,4560155,4701957,4985382,0.13333825659203827,0.2607623648498751
Solomon Islands,Netherlands,0,0,0,0,15,15,13,13,1,0,0,-2,-0.13333333333333333,-2,-0.13333333333333333,SLB,NLD,429978,540394,612660,691191,15925513,16615394,16939923,17441500,1.8808115267704584,0.07453487372072355
South Korea,Lithuania,0,0,0,0,0,0,13,13,1,0,0,13,1,13,1,KOR,LTU,47008111,49554112,51014947,51836239,3499536,3097282,2904910,2794885,0.025078979977694753,0.4651354170207361
Vanuatu,Belgium,0,0,0,0,12,15,13,13,1,0,0,1,0.08333333333333333,-2,-0.13333333333333333,VUT,BEL,192074,245453,276438,311685,10251250,10895586,11274196,11538604,4.170877648908353,0.1126652756260636
Vietnam,Bolivia (Plurinational State of),1,3,4,7,10,13,13,12,12,3,0.75,3,0.3,0,0,VNM,BOL,79001142,87411012,92191398,96648685,8592656,10223270,11090085,11936162,0.013450777938675523,0.10891273090965085
Vietnam,Liechtenstein,0,0,0,0,11,12,13,13,1,0,0,2,0.18181818181818182,1,0.08333333333333333,VNM,LIE,79001142,87411012,92191398,96648685,33026,35926,37355,38756,0.013450777938675523,33.543193312003304
Bangladesh,Iceland,0,0,0,0,0,4,12,12,1,0,0,12,1,8,2,BGD,ISL,129193327,148391139,157830000,167420951,281205,318041,330815,366463,0.007167561722905277,3.274546134261849
Bhutan,Hungary,0,0,0,0,0,1,12,12,1,0,0,12,1,11,11,BTN,HUN,587207,705516,743274,772506,10210971,10000023,9843028,9750149,1.5533859931185001,0.12307504223781605
Italy,Bhutan,6,7,8,10,12,13,12,6,1,2,0.25,0,0,-1,-0.07692307692307693,ITA,BTN,56942108,59277417,60730582,59438851,587207,705516,743274,772506,0.020188815561054504,1.5533859931185001
Nepal,Slovakia,0,0,0,0,0,9,12,12,1,0,0,12,1,3,0.3333333333333333,NPL,SVK,24559500,27161567,27610325,29348627,5388720,5391428,5423801,5458827,0.04088777304641883,0.21982744644591226
Pakistan,Venezuela (Bolivarian Republic of),12,11,11,11,13,14,12,0,0,-1,-0.09090909090909091,-1,-0.07692307692307693,-2,-0.14285714285714285,PAK,VEN,154369924,194454498,210969298,227196741,24427729,28715022,30529716,28490453,0.00528176590349947,0.0421193724087153
Papua New Guinea,Norway,0,0,0,0,9,8,12,12,1,0,0,3,0.3333333333333333,4,0.5,PNG,NOR,5508297,7583269,8682174,9749640,4490967,4889252,5188607,5379475,0.12308146762341993,0.22307009513010098
Poland,Mongolia,5,4,5,7,11,13,12,7,1.4,0,0,1,0.09090909090909091,-1,-0.07692307692307693,POL,MNG,38258629,38042794,37986412,37899070,2450979,2702520,2964749,3294335,0.03166304608529972,0.36426167951953886
Vanuatu,Samoa,9,15,22,20,17,14,12,3,0.3333333333333333,13,0.5909090909090909,-5,-0.29411764705882354,-2,-0.14285714285714285,VUT,WSM,192074,245453,276438,311685,184008,194672,203571,214929,3.8500409066846335,5.583239116173248
Cambodia,Ireland,2,5,12,13,11,11,11,9,4.5,10,0.8333333333333334,0,0,0,0,KHM,IRL,12118841,14363532,15417523,16396860,3805174,4560155,4701957,4985382,0.06708601524926114,0.22064507794989432
India,El Salvador,18,14,10,11,11,11,11,-7,-0.3888888888888889,-8,-0.8,0,0,0,0,IND,SLV,1059633675,1240613620,1322866505,1396387127,5958482,6114034,6231066,6292731,7.877471646156189e-4,0.174804866122515
Indonesia,Faroe Islands,1,1,0,3,6,10,11,10,10,-1,1,5,0.8333333333333334,1,0.1,IDN,FRO,214072421,244016173,259091970,271857970,45660,48410,48816,52415,0.004046230463649824,20.98635886673662
Malaysia,Lithuania,0,0,0,0,0,1,11,11,1,0,0,11,1,10,10,MYS,LTU,22945150,28717731,31068833,33199993,3499536,3097282,2904910,2794885,0.033132537106257826,0.393576122094469
Maldives,Brazil,0,0,0,0,10,11,11,11,1,0,0,1,0.1,0,0,MDV,BRA,282507,361575,435582,514438,175873720,196353492,205188205,213196304,2.138255727609547,0.0051595641170214665
Myanmar,Egypt,9,9,9,11,12,8,11,2,0.2222222222222222,0,0,-1,-0.08333333333333333,3,0.375,MMR,EGY,45538332,49390988,51483949,53423198,71371371,87252413,97723799,107465134,0.020590306106347284,0.010235877991833148
Myanmar,Romania,0,0,0,0,0,0,11,11,1,0,0,11,1,11,1,MMR,ROU,45538332,49390988,51483949,53423198,22442971,20246871,19815616,19265250,0.020590306106347284,0.05709762396023929
Pakistan,Costa Rica,6,5,7,6,10,9,11,5,0.8333333333333334,1,0.14285714285714285,1,0.1,2,0.2222222222222222,PAK,CRI,154369924,194454498,210969298,227196741,3979193,4622252,4895242,5123105,0.004841618744874513,0.21471353798136092
Papua New Guinea,Finland,1,2,3,6,7,10,11,10,10,2,0.6666666666666666,4,0.5714285714285714,1,0.1,PNG,FIN,5508297,7583269,8682174,9749640,5176209,5363352,5479531,5529543,0.11282467865480161,0.1989314487652958
Solomon Islands,Austria,8,9,10,10,11,5,11,3,0.375,2,0.2,0,0,6,1.2,SLB,AUT,429978,540394,612660,691191,8011566,8363404,8642699,8916864,1.591455907267311,0.12336175588188852
Timor-Leste,France,1,1,1,6,11,12,11,10,10,0,0,0,0,-1,-0.08333333333333333,TLS,FRA,878360,1088486,1205813,1299995,60921384,65030575,66548272,67571107,0.8461571006042331,0.01627914723966266
Vanuatu,Netherlands,0,0,0,0,10,9,11,11,1,0,0,1,0.1,2,0.2222222222222222,VUT,NLD,192074,245453,276438,311685,15925513,16615394,16939923,17441500,3.5292041644609142,0.06306797007138149
Vanuatu,Switzerland,0,0,0,0,0,28,11,11,1,0,0,11,1,-17,-0.6071428571428571,VUT,CHE,192074,245453,276438,311685,7184250,7824909,8282396,8638167,3.5292041644609142,0.12734183073793318
Cambodia,Slovakia,0,0,0,0,0,8,10,10,1,0,0,10,1,2,0.25,KHM,SVK,12118841,14363532,15417523,16396860,5388720,5391428,5423801,5458827,0.060987286590237395,0.1831895387049269
China,Greenland,0,0,1,5,7,11,10,10,1,1,1,3,0.42857142857142855,-1,-0.09090909090909091,CHN,GRL,1262645000,1337705000,1379860000,1411100000,56200,56905,56114,56367,7.08666997377932e-4,17.74087675412919
Hungary,Mongolia,0,0,0,4,9,11,10,10,1,0,0,1,0.1111111111111111,-1,-0.09090909090909091,HUN,MNG,10210971,10000023,9843028,9750149,2450979,2702520,2964749,3294335,0.10256253519818005,0.3035513995996157
Indonesia,Bolivia (Plurinational State of),12,14,15,12,9,11,10,-2,-0.16666666666666666,3,0.2,1,0.1111111111111111,-1,-0.09090909090909091,IDN,BOL,214072421,244016173,259091970,271857970,8592656,10223270,11090085,11936162,0.0036783913305907493,0.0837790237766545
Indonesia,Lithuania,0,0,0,0,0,2,10,10,1,0,0,10,1,8,4,IDN,LTU,214072421,244016173,259091970,271857970,3499536,3097282,2904910,2794885,0.0036783913305907493,0.35779647463133546
Iran,Cayman Islands,2,6,11,10,10,9,10,8,4,9,0.8181818181818182,0,0,1,0.1111111111111111,IRN,CYM,65544383,75373855,81790841,87290193,39658,54074,60911,67311,0.011456040657396645,14.856412770572417
North Korea,Bolivia (Plurinational State of),122,63,3,6,9,11,10,-112,-0.9180327868852459,-119,-39.666666666666664,1,0.1111111111111111,-1,-0.09090909090909091,PRK,BOL,23367059,24686435,25258015,25867467,8592656,10223270,11090085,11936162,0.03865859768952252,0.0837790237766545
North Korea,Latvia,204,109,14,14,14,11,10,-194,-0.9509803921568627,-190,-13.571428571428571,-4,-0.2857142857142857,-1,-0.09090909090909091,PRK,LVA,23367059,24686435,25258015,25867467,2367550,2097555,1977527,1900449,0.03865859768952252,0.5261914421276235
Solomon Islands,Guinea,0,0,0,0,0,12,10,10,1,0,0,10,1,-2,-0.16666666666666666,SLB,GIN,429978,540394,612660,691191,8336967,10270728,11625998,13205153,1.4467780975157372,0.07572801314759474
Vietnam,Venezuela (Bolivarian Republic of),10,10,10,10,11,12,10,0,0,0,0,-1,-0.09090909090909091,-2,-0.16666666666666666,VNM,VEN,79001142,87411012,92191398,96648685,24427729,28715022,30529716,28490453,0.010346752260519633,0.03509947700726275
Afghanistan,Argentina,20,20,20,16,9,9,9,-11,-0.55,0,0,0,0,0,0,AFG,ARG,19542982,28189672,33753499,38972230,37070774,40788453,43131966,45376763,0.023093366738315975,0.019833940116001664
Fiji,Finland,5,6,6,7,7,9,9,4,0.8,1,0.16666666666666666,2,0.2857142857142857,0,0,FJI,FIN,832509,905169,917200,920422,5176209,5363352,5479531,5529543,0.9778123512910383,0.16276209444433293
Indonesia,Liechtenstein,0,0,0,0,4,8,9,9,1,0,0,5,1.25,1,0.125,IDN,LIE,214072421,244016173,259091970,271857970,33026,35926,37355,38756,0.003310552197531674,23.222210754463827
Lebanon,Maldives,7,7,8,8,9,10,9,2,0.2857142857142857,1,0.125,0,0,-1,-0.1,LBN,MDV,4320642,4995800,6398940,5662923,282507,361575,435582,514438,0.1589285250744183,1.7494819589532653
Myanmar,Argentina,19,19,19,15,9,9,9,-10,-0.5263157894736842,0,0,0,0,0,0,MMR,ARG,45538332,49390988,51483949,53423198,37070774,40788453,43131966,45376763,0.016846614087011415,0.019833940116001664
Myanmar,Luxembourg,0,0,0,0,0,0,9,9,1,0,0,9,1,9,1,MMR,LUX,45538332,49390988,51483949,53423198,436300,506953,569604,630419,0.016846614087011415,1.4276219466735616
Nepal,Costa Rica,7,5,6,5,9,8,9,2,0.2857142857142857,-1,-0.16666666666666666,0,0,1,0.125,NPL,CRI,24559500,27161567,27610325,29348627,3979193,4622252,4895242,5123105,0.030665829784814122,0.17567471289384073
Papua New Guinea,Denmark,4,6,7,8,8,6,9,5,1.25,3,0.42857142857142855,1,0.125,3,0.5,PNG,DNK,5508297,7583269,8682174,9749640,5339616,5547683,5683483,5831404,0.09231110071756496,0.1543367600667009
Thailand,Bolivia (Plurinational State of),2,6,10,9,8,10,9,7,3.5,8,0.8,1,0.125,-1,-0.1,THA,BOL,63066603,68270489,70294397,71475664,8592656,10223270,11090085,11936162,0.012591698343648825,0.07540112139898905
Bhutan,Dominican Republic,9,10,11,10,9,8,8,-1,-0.1111111111111111,2,0.18181818181818182,-1,-0.1111111111111111,0,0,BTN,DOM,587207,705516,743274,772506,8540791,9775755,10405832,10999664,1.035590662079,0.07272949428273447
Hong Kong,El Salvador,13,10,7,8,8,8,8,-5,-0.38461538461538464,-6,-0.8571428571428571,0,0,0,0,HKG,SLV,6665000,7024200,7291300,7481000,5958482,6114034,6231066,6292731,0.10693757519048255,0.12713081172546548
Malaysia,Bolivia (Plurinational State of),5,6,7,7,7,9,8,3,0.6,2,0.2857142857142857,1,0.14285714285714285,-1,-0.1111111111111111,MYS,BOL,22945150,28717731,31068833,33199993,8592656,10223270,11090085,11936162,0.02409639062273296,0.0670232190213236
Malaysia,Latvia,7,10,14,9,4,7,8,1,0.14285714285714285,7,0.5,4,1,1,0.14285714285714285,MYS,LVA,22945150,28717731,31068833,33199993,2367550,2097555,1977527,1900449,0.02409639062273296,0.42095315370209885
Malaysia,Saint Lucia,6,6,11,11,11,10,8,2,0.3333333333333333,5,0.45454545454545453,-3,-0.2727272727272727,-2,-0.2,MYS,LCA,22945150,28717731,31068833,33199993,159500,170935,175623,179237,0.02409639062273296,4.463364149143313
Maldives,Denmark,3,3,2,5,7,0,8,5,1.6666666666666667,-1,-0.5,1,0.14285714285714285,8,1,MDV,DNK,282507,361575,435582,514438,5339616,5547683,5683483,5831404,1.555095074625125,0.1371882311704008
Solomon Islands,Samoa,5,10,16,14,13,10,8,3,0.6,11,0.6875,-5,-0.38461538461538464,-2,-0.2,SLB,WSM,429978,540394,612660,691191,184008,194672,203571,214929,1.15742247801259,3.7221594107821656
Sri Lanka,Liechtenstein,0,0,0,0,7,8,8,8,1,0,0,1,0.14285714285714285,0,0,LKA,LIE,18776371,20668557,21336697,21919000,33026,35926,37355,38756,0.03649801542041151,20.641965115078957
Thailand,Costa Rica,4,4,5,4,8,7,8,4,1,1,0.2,0,0,1,0.14285714285714285,THA,CRI,63066603,68270489,70294397,71475664,3979193,4622252,4895242,5123105,0.011192620749910067,0.15615530035008066
Timor-Leste,Norway,0,0,0,0,14,15,8,8,1,0,0,-6,-0.42857142857142855,-7,-0.4666666666666667,TLS,NOR,878360,1088486,1205813,1299995,4490967,4889252,5188607,5379475,0.615386982257624,0.14871339675340067
Vanuatu,Argentina,18,18,18,14,8,8,8,-10,-0.5555555555555556,0,0,0,0,0,0,VUT,ARG,192074,245453,276438,311685,37070774,40788453,43131966,45376763,2.5666939377897555,0.01763016899200148
Cambodia,Guinea,0,0,0,0,0,9,7,7,1,0,0,7,1,-2,-0.2222222222222222,KHM,GIN,12118841,14363532,15417523,16396860,8336967,10270728,11625998,13205153,0.04269110061316618,0.053009609203316314
Ireland,Mongolia,2,1,2,4,7,8,7,5,2.5,0,0,0,0,-1,-0.125,IRL,MNG,3805174,4560155,4701957,4985382,2450979,2702520,2964749,3294335,0.14041050414993275,0.212485979719731
Pakistan,Liechtenstein,0,0,0,0,4,7,7,7,1,0,0,3,0.75,0,0,PAK,LIE,154369924,194454498,210969298,227196741,33026,35926,37355,38756,0.003081030110374691,18.061719475694083
Pakistan,Lithuania,35,40,31,50,63,91,7,-28,-0.8,-4,-0.12903225806451613,-56,-0.8888888888888888,-84,-0.9230769230769231,PAK,LTU,154369924,194454498,210969298,227196741,3499536,3097282,2904910,2794885,0.003081030110374691,0.25045753224193484
Solomon Islands,Italy,1,3,5,5,3,3,7,6,6,4,0.8,4,1.3333333333333333,4,1.3333333333333333,SLB,ITA,429978,540394,612660,691191,56942108,59277417,60730582,59438851,1.012744668261016,0.011776809077281793
Thailand,Puerto Rico,35,36,39,30,18,18,7,-28,-0.8,4,0.10256410256410256,-11,-0.6111111111111112,-11,-0.6111111111111112,THA,PRI,63066603,68270489,70294397,71475664,3810605,3721525,3473232,3281557,0.009793543156171309,0.21331337532762648
Timor-Leste,Cabo Verde,11,14,17,13,8,8,7,-4,-0.36363636363636365,6,0.35294117647058826,-1,-0.125,-1,-0.125,TLS,CPV,878360,1088486,1205813,1299995,458251,521212,552166,582640,0.538463609475421,1.2014279829740493
Afghanistan,Cyprus,2,3,4,6,8,7,6,4,2,2,0.5,-2,-0.25,-1,-0.14285714285714285,AFG,CYP,19542982,28189672,33753499,38972230,948237,1129686,1187280,1237537,0.015395577825543983,0.48483398880195094
Afghanistan,Liechtenstein,0,0,0,0,3,4,6,6,1,0,0,3,1,2,0.5,AFG,LIE,19542982,28189672,33753499,38972230,33026,35926,37355,38756,0.015395577825543983,15.481473836309215
Bangladesh,El Salvador,11,9,6,6,6,6,6,-5,-0.45454545454545453,-5,-0.8333333333333334,0,0,0,0,BGD,SLV,129193327,148391139,157830000,167420951,5958482,6114034,6231066,6292731,0.0035837808614526383,0.09534810879409909
Bangladesh,Liechtenstein,0,0,0,0,2,2,6,6,1,0,0,4,2,4,2,BGD,LIE,129193327,148391139,157830000,167420951,33026,35926,37355,38756,0.0035837808614526383,15.481473836309215
Bhutan,Ireland,1,4,8,8,7,7,6,5,5,7,0.875,-1,-0.14285714285714285,-1,-0.14285714285714285,BTN,IRL,587207,705516,743274,772506,3805174,4560155,4701957,4985382,0.7766929965592501,0.12035186069994235
Bhutan,Romania,0,0,0,0,0,4,6,6,1,0,0,6,1,2,0.5,BTN,ROU,587207,705516,743274,772506,22442971,20246871,19815616,19265250,0.7766929965592501,0.031144158523766882
Cambodia,Estonia,0,0,0,0,4,9,6,6,1,0,0,2,0.5,-3,-0.3333333333333333,KHM,EST,12118841,14363532,15417523,16396860,1396985,1331475,1315407,1329522,0.03659237195414244,0.45129001250073336
Fiji,Czechia,2,3,4,4,3,5,6,4,2,2,0.5,3,1,1,0.2,FJI,CZE,832509,905169,917200,920422,10255063,10474410,10546059,10697858,0.6518749008606922,0.05608599403731102
Iran,Yemen,0,0,0,0,10,7,6,6,1,0,0,-4,-0.4,-1,-0.14285714285714285,IRN,YEM,65544383,75373855,81790841,87290193,18628700,24743946,28516545,32284046,0.0068736243944379875,0.0185850311327149
Nepal,Bolivia (Plurinational State of),0,1,1,3,5,7,6,6,1,1,1,1,0.2,-1,-0.14285714285714285,NPL,BOL,24559500,27161567,27610325,29348627,8592656,10223270,11090085,11936162,0.020443886523209415,0.0502674142659927
North Korea,Lithuania,0,0,0,0,0,7,6,6,1,0,0,6,1,-1,-0.14285714285714285,PRK,LTU,23367059,24686435,25258015,25867467,3499536,3097282,2904910,2794885,0.02319515861371351,0.2146778847788013
South Korea,Cyprus,2,3,4,6,8,7,6,4,2,2,0.5,-2,-0.25,-1,-0.14285714285714285,KOR,CYP,47008111,49554112,51014947,51836239,948237,1129686,1187280,1237537,0.011574913835859119,0.48483398880195094
Vanuatu,Austria,4,5,5,5,5,7,6,2,0.5,1,0.2,1,0.2,-1,-0.14285714285714285,VUT,AUT,192074,245453,276438,311685,8011566,8363404,8642699,8916864,1.9250204533423168,0.06728823048103011
Fiji,Romania,0,0,0,0,0,0,5,5,1,0,0,5,1,5,1,FJI,ROU,832509,905169,917200,920422,22442971,20246871,19815616,19265250,0.5432290840505768,0.025953465436472405
Laos,Brazil,0,0,0,2,6,6,5,5,1,0,0,-1,-0.16666666666666666,-1,-0.16666666666666666,LAO,BRA,5430853,6323418,6787419,7319399,175873720,196353492,205188205,213196304,0.06831161957423007,0.002345256416827939
Laos,Slovakia,0,0,0,0,0,6,5,5,1,0,0,5,1,-1,-0.16666666666666666,LAO,SVK,5430853,6323418,6787419,7319399,5388720,5391428,5423801,5458827,0.06831161957423007,0.09159476935246345
Maldives,Czechia,0,0,0,2,3,2,5,5,1,0,0,2,0.6666666666666666,3,1.5,MDV,CZE,282507,361575,435582,514438,10255063,10474410,10546059,10697858,0.9719344216407031,0.046738328364425846
Maldives,France,4,4,4,8,6,6,5,1,0.25,0,0,-1,-0.16666666666666666,-1,-0.16666666666666666,MDV,FRA,282507,361575,435582,514438,60921384,65030575,66548272,67571107,0.9719344216407031,0.007399612381664844
Mongolia,Greece,9,10,12,10,8,7,5,-4,-0.4444444444444444,3,0.25,-3,-0.375,-2,-0.2857142857142857,MNG,GRC,2450979,2702520,2964749,3294335,10805808,11121341,10820883,10698599,0.15177569979980784,0.04673509120212843
Mongolia,Slovenia,0,0,0,2,5,4,5,5,1,0,0,0,0,1,0.25,MNG,SVN,2450979,2702520,2964749,3294335,1988925,2048583,2063531,2102419,0.15177569979980784,0.2378212906180928
North Korea,Finland,3,2,1,2,2,4,5,2,0.6666666666666666,-2,-2,3,1.5,1,0.25,PRK,FIN,23367059,24686435,25258015,25867467,5176209,5363352,5479531,5529543,0.01932929884476126,0.09042338580240718
Pakistan,Argentina,10,10,10,9,5,5,5,-5,-0.5,0,0,0,0,0,0,PAK,ARG,154369924,194454498,210969298,227196741,37070774,40788453,43131966,45376763,0.002200735793124779,0.011018855620000925
Timor-Leste,Sweden,0,0,0,1,4,4,5,5,1,0,0,1,0.25,1,0.25,TLS,SWE,878360,1088486,1205813,1299995,8872109,9378126,9799186,10353442,0.38461686391101507,0.04829311836585359
Vietnam,Argentina,11,11,11,9,5,5,5,-6,-0.5454545454545454,0,0,0,0,0,0,VNM,ARG,79001142,87411012,92191398,96648685,37070774,40788453,43131966,45376763,0.005173376130259816,0.011018855620000925
Afghanistan,Costa Rica,25,11,3,3,5,4,4,-21,-0.84,-22,-7.333333333333333,-1,-0.2,0,0,AFG,CRI,19542982,28189672,33753499,38972230,3979193,4622252,4895242,5123105,0.010263718550362655,0.07807765017504033
Bhutan,Costa Rica,3,2,3,3,5,4,4,1,0.3333333333333333,0,0,-1,-0.2,0,0,BTN,CRI,587207,705516,743274,772506,3979193,4622252,4895242,5123105,0.5177953310395,0.07807765017504033
Cambodia,Lithuania,0,0,0,0,0,5,4,4,1,0,0,4,1,-1,-0.2,KHM,LTU,12118841,14363532,15417523,16396860,3499536,3097282,2904910,2794885,0.024394914636094958,0.14311858985253417
Fiji,Hungary,0,0,0,0,0,4,4,4,1,0,0,4,1,0,0,FJI,HUN,832509,905169,917200,920422,10210971,10000023,9843028,9750149,0.4345832672404614,0.04102501407927202
Fiji,Luxembourg,0,0,0,0,0,0,4,4,1,0,0,4,1,4,1,FJI,LUX,832509,905169,917200,920422,436300,506953,569604,630419,0.4345832672404614,0.6344986429660273
Hong Kong,Argentina,9,9,9,8,4,4,4,-5,-0.5555555555555556,0,0,0,0,0,0,HKG,ARG,6665000,7024200,7291300,7481000,37070774,40788453,43131966,45376763,0.05346878759524128,0.00881508449600074
Laos,Costa Rica,3,2,3,3,5,4,4,1,0.3333333333333333,0,0,-1,-0.2,0,0,LAO,CRI,5430853,6323418,6787419,7319399,3979193,4622252,4895242,5123105,0.054649295659384055,0.07807765017504033
Malaysia,Costa Rica,3,2,3,3,5,4,4,1,0.3333333333333333,0,0,-1,-0.2,0,0,MYS,CRI,22945150,28717731,31068833,33199993,3979193,4622252,4895242,5123105,0.01204819531136648,0.07807765017504033
Maldives,Belgium,2,2,2,2,4,4,4,2,1,0,0,0,0,0,0,MDV,BEL,282507,361575,435582,514438,10251250,10895586,11274196,11538604,0.7775475373125625,0.03466623865417341
Maldives,Norway,0,0,0,0,4,5,4,4,1,0,0,0,0,-1,-0.2,MDV,NOR,282507,361575,435582,514438,4490967,4889252,5188607,5379475,0.7775475373125625,0.07435669837670034
Myanmar,Iceland,0,0,0,0,1,1,4,4,1,0,0,3,3,3,3,MMR,ISL,45538332,49390988,51483949,53423198,281205,318041,330815,366463,0.007487384038671739,1.091515378087283
Papua New Guinea,Hungary,0,1,1,1,1,4,4,4,1,1,1,3,3,0,0,PNG,HUN,5508297,7583269,8682174,9749640,10210971,10000023,9843028,9750149,0.041027155874473316,0.04102501407927202
Papua New Guinea,Luxembourg,0,0,0,0,0,0,4,4,1,0,0,4,1,4,1,PNG,LUX,5508297,7583269,8682174,9749640,436300,506953,569604,630419,0.041027155874473316,0.6344986429660273
Rwanda,Thailand,0,0,1,2,4,4,4,4,1,1,1,0,0,0,0,RWA,THA,8109989,10309031,11642959,13146362,63066603,68270489,70294397,71475664,0.03042666860991657,0.005596310374955033
Solomon Islands,Norway,0,0,0,0,3,6,4,4,1,0,0,1,0.3333333333333333,-2,-0.3333333333333333,SLB,NOR,429978,540394,612660,691191,4490967,4889252,5188607,5379475,0.578711239006295,0.07435669837670034
South Korea,Liechtenstein,0,0,0,0,4,4,4,4,1,0,0,0,0,0,0,KOR,LIE,47008111,49554112,51014947,51836239,33026,35926,37355,38756,0.007716609223906079,10.320982557539478
South Korea,Puerto Rico,72,78,85,102,107,114,4,-68,-0.9444444444444444,13,0.15294117647058825,-103,-0.9626168224299065,-110,-0.9649122807017544,KOR,PRI,47008111,49554112,51014947,51836239,3810605,3721525,3473232,3281557,0.007716609223906079,0.12189335733007227
Timor-Leste,Belgium,0,0,0,0,3,7,4,4,1,0,0,1,0.3333333333333333,-3,-0.42857142857142855,TLS,BEL,878360,1088486,1205813,1299995,10251250,10895586,11274196,11538604,0.307693491128812,0.03466623865417341
Vanuatu,Denmark,4,4,4,4,3,4,4,0,0,0,0,1,0.3333333333333333,0,0,VUT,DNK,192074,245453,276438,311685,5339616,5547683,5683483,5831404,1.2833469688948778,0.0685941155852004
Bangladesh,Costa Rica,13,6,2,2,4,3,3,-10,-0.7692307692307693,-11,-5.5,-1,-0.25,0,0,BGD,CRI,129193327,148391139,157830000,167420951,3979193,4622252,4895242,5123105,0.0017918904307263192,0.05855823763128025
Bhutan,Czechia,0,0,0,2,3,2,3,3,1,0,0,0,0,1,0.5,BTN,CZE,587207,705516,743274,772506,10255063,10474410,10546059,10697858,0.38834649827962503,0.02804299701865551
Bhutan,Estonia,0,0,0,0,0,0,3,3,1,0,0,3,1,3,1,BTN,EST,587207,705516,743274,772506,1396985,1331475,1315407,1329522,0.38834649827962503,0.22564500625036668
Cambodia,Costa Rica,2,2,2,2,4,3,3,1,0.5,0,0,-1,-0.25,0,0,KHM,CRI,12118841,14363532,15417523,16396860,3979193,4622252,4895242,5123105,0.01829618597707122,0.05855823763128025
Cambodia,Slovenia,0,0,0,0,2,6,3,3,1,0,0,1,0.5,-3,-0.5,KHM,SVN,12118841,14363532,15417523,16396860,1988925,2048583,2063531,2102419,0.01829618597707122,0.14269277437085567
Indonesia,Latvia,2,2,3,3,3,3,3,1,0.5,1,0.3333333333333333,0,0,0,0,IDN,LVA,214072421,244016173,259091970,271857970,2367550,2097555,1977527,1900449,0.0011035173991772247,0.15785743263828705
Laos,Lithuania,0,0,0,0,0,0,3,3,1,0,0,3,1,3,1,LAO,LTU,5430853,6323418,6787419,7319399,3499536,3097282,2904910,2794885,0.040986971744538046,0.10733894238940064
Maldives,Slovenia,0,0,0,0,0,1,3,3,1,0,0,3,1,2,2,MDV,SVN,282507,361575,435582,514438,1988925,2048583,2063531,2102419,0.5831606529844219,0.14269277437085567
Myanmar,Slovakia,0,0,0,0,0,4,3,3,1,0,0,3,1,-1,-0.25,MMR,SVK,45538332,49390988,51483949,53423198,5388720,5391428,5423801,5458827,0.005615538029003805,0.054956861611478065
North Korea,Czechia,21,32,43,35,25,13,3,-18,-0.8571428571428571,22,0.5116279069767442,-22,-0.88,-10,-0.7692307692307693,PRK,CZE,23367059,24686435,25258015,25867467,10255063,10474410,10546059,10697858,0.011597579306856756,0.02804299701865551
North Korea,Estonia,0,0,0,0,6,4,3,3,1,0,0,-3,-0.5,-1,-0.25,PRK,EST,23367059,24686435,25258015,25867467,1396985,1331475,1315407,1329522,0.011597579306856756,0.22564500625036668
Papua New Guinea,Romania,0,0,0,0,0,0,3,3,1,0,0,3,1,3,1,PNG,ROU,5508297,7583269,8682174,9749640,22442971,20246871,19815616,19265250,0.03077036690585498,0.015572079261883441
Solomon Islands,Belgium,0,0,0,0,6,4,3,3,1,0,0,-3,-0.5,-1,-0.25,SLB,BEL,429978,540394,612660,691191,10251250,10895586,11274196,11538604,0.4340334292547212,0.025999678990630062
Solomon Islands,Sweden,0,0,2,4,4,4,3,3,1,2,1,-1,-0.25,-1,-0.25,SLB,SWE,429978,540394,612660,691191,8872109,9378126,9799186,10353442,0.4340334292547212,0.028975871019512156
Vietnam,Guinea,0,0,0,0,0,5,3,3,1,0,0,3,1,-2,-0.4,VNM,GIN,79001142,87411012,92191398,96648685,8336967,10270728,11625998,13205153,0.0031040256781558902,0.022718403944278417
Bhutan,Finland,0,0,0,2,3,3,2,2,1,0,0,-1,-0.3333333333333333,-1,-0.3333333333333333,BTN,FIN,587207,705516,743274,772506,5176209,5363352,5479531,5529543,0.25889766551975,0.036169354320962875
Cambodia,Liechtenstein,0,0,0,0,3,4,2,2,1,0,0,-1,-0.3333333333333333,-2,-0.5,KHM,LIE,12118841,14363532,15417523,16396860,33026,35926,37355,38756,0.012197457318047479,5.160491278769739
Ethiopia,Thailand,0,0,0,0,2,2,2,2,1,0,0,0,0,0,0,ETH,THA,67031867,89237791,102471895,117190911,63066603,68270489,70294397,71475664,0.0017066169918245621,0.0027981551874775167
Finland,Mongolia,20,21,24,12,3,3,2,-18,-0.9,4,0.16666666666666666,-1,-0.3333333333333333,-1,-0.3333333333333333,FIN,MNG,5176209,5363352,5479531,5529543,2450979,2702520,2964749,3294335,0.036169354320962875,0.060710279919923144
Hong Kong,Bolivia (Plurinational State of),0,8,15,9,2,3,2,2,1,15,1,0,0,-1,-0.3333333333333333,HKG,BOL,6665000,7024200,7291300,7481000,8592656,10223270,11090085,11936162,0.02673439379762064,0.0167558047553309
Laos,Romania,0,0,0,0,0,0,2,2,1,0,0,2,1,2,1,LAO,ROU,5430853,6323418,6787419,7319399,22442971,20246871,19815616,19265250,0.027324647829692027,0.010381386174588962
Laos,Slovenia,0,0,0,0,1,3,2,2,1,0,0,1,1,-1,-0.3333333333333333,LAO,SVN,5430853,6323418,6787419,7319399,1988925,2048583,2063531,2102419,0.027324647829692027,0.0951285162472371
Malaysia,Argentina,6,6,6,5,2,2,2,-4,-0.6666666666666666,0,0,0,0,0,0,MYS,ARG,22945150,28717731,31068833,33199993,37070774,40788453,43131966,45376763,0.00602409765568324,0.00440754224800037
North Korea,Sierra Leone,7,6,5,3,3,3,2,-5,-0.7142857142857143,-2,-0.4,-1,-0.3333333333333333,-1,-0.3333333333333333,PRK,SLE,23367059,24686435,25258015,25867467,4584067,6436698,7314773,8233970,0.0077317195379045045,0.024289619709569017
North Macedonia,Mongolia,12,13,15,8,3,3,2,-10,-0.8333333333333334,3,0.2,-1,-0.3333333333333333,-1,-0.3333333333333333,MKD,MNG,2026350,1946298,1912430,1856124,2450979,2702520,2964749,3294335,0.10775142178001038,0.060710279919923144
Papua New Guinea,Slovakia,0,0,0,0,0,3,2,2,1,0,0,2,1,-1,-0.3333333333333333,PNG,SVK,5508297,7583269,8682174,9749640,5388720,5391428,5423801,5458827,0.020513577937236658,0.03663790774098538
Papua New Guinea,Slovenia,0,0,0,0,2,2,2,2,1,0,0,0,0,0,0,PNG,SVN,5508297,7583269,8682174,9749640,1988925,2048583,2063531,2102419,0.020513577937236658,0.0951285162472371
Slovakia,Mongolia,4,4,5,3,3,3,2,-2,-0.5,1,0.2,-1,-0.3333333333333333,-1,-0.3333333333333333,SVK,MNG,5388720,5391428,5423801,5458827,2450979,2702520,2964749,3294335,0.03663790774098538,0.060710279919923144
Solomon Islands,Denmark,2,2,2,3,3,4,2,0,0,0,0,-1,-0.3333333333333333,-2,-0.5,SLB,DNK,429978,540394,612660,691191,5339616,5547683,5683483,5831404,0.2893556195031475,0.0342970577926002
Solomon Islands,Finland,0,0,0,2,4,5,2,2,1,0,0,-2,-0.5,-3,-0.6,SLB,FIN,429978,540394,612660,691191,5176209,5363352,5479531,5529543,0.2893556195031475,0.036169354320962875
Solomon Islands,France,4,4,4,6,3,3,2,-2,-0.5,0,0,-1,-0.3333333333333333,-1,-0.3333333333333333,SLB,FRA,429978,540394,612660,691191,60921384,65030575,66548272,67571107,0.2893556195031475,0.0029598449526659376
Solomon Islands,Slovakia,0,0,0,0,0,3,2,2,1,0,0,2,1,-1,-0.3333333333333333,SLB,SVK,429978,540394,612660,691191,5388720,5391428,5423801,5458827,0.2893556195031475,0.03663790774098538
Sri Lanka,Argentina,6,6,6,5,2,2,2,-4,-0.6666666666666666,0,0,0,0,0,0,LKA,ARG,18776371,20668557,21336697,21919000,37070774,40788453,43131966,45376763,0.009124503855102878,0.00440754224800037
Sri Lanka,Bolivia (Plurinational State of),0,3,5,4,2,3,2,2,1,5,1,0,0,-1,-0.3333333333333333,LKA,BOL,18776371,20668557,21336697,21919000,8592656,10223270,11090085,11936162,0.009124503855102878,0.0167558047553309
Timor-Leste,Ireland,1,2,5,4,3,3,2,1,1,4,0.8,-1,-0.3333333333333333,-1,-0.3333333333333333,TLS,IRL,878360,1088486,1205813,1299995,3805174,4560155,4701957,4985382,0.153846745564406,0.040117286899980786
Togo,Thailand,0,0,0,0,2,2,2,2,1,0,0,0,0,0,0,TGO,THA,5008035,6571855,7473229,8442580,63066603,68270489,70294397,71475664,0.023689440905505187,0.0027981551874775167
Afghanistan,Bolivia (Plurinational State of),2,1,0,1,1,2,1,-1,-0.5,-2,1,0,0,-1,-0.5,AFG,BOL,19542982,28189672,33753499,38972230,8592656,10223270,11090085,11936162,0.0025659296375906636,0.00837790237766545
Afghanistan,Guinea,0,0,0,0,0,3,1,1,1,0,0,1,1,-2,-0.6666666666666666,AFG,GIN,19542982,28189672,33753499,38972230,8336967,10270728,11625998,13205153,0.0025659296375906636,0.007572801314759473
Afghanistan,Thailand,0,9,20,11,1,1,1,1,1,20,1,0,0,0,0,AFG,THA,19542982,28189672,33753499,38972230,63066603,68270489,70294397,71475664,0.0025659296375906636,0.0013990775937387583
Bhutan,Guinea,0,0,0,0,0,3,1,1,1,0,0,1,1,-2,-0.6666666666666666,BTN,GIN,587207,705516,743274,772506,8336967,10270728,11625998,13205153,0.129448832759875,0.007572801314759473
Bhutan,Luxembourg,0,0,0,0,0,0,1,1,1,0,0,1,1,1,1,BTN,LUX,587207,705516,743274,772506,436300,506953,569604,630419,0.129448832759875,0.15862466074150683
Cambodia,Iceland,1,2,2,3,4,1,1,0,0,1,0.5,-3,-0.75,0,0,KHM,ISL,12118841,14363532,15417523,16396860,281205,318041,330815,366463,0.0060987286590237395,0.27287884452182076
Fiji,Argentina,1,1,1,2,1,1,1,0,0,0,0,0,0,0,0,FJI,ARG,832509,905169,917200,920422,37070774,40788453,43131966,45376763,0.10864581681011536,0.002203771124000185
Fiji,Costa Rica,1,1,1,2,2,1,1,0,0,0,0,-1,-0.5,0,0,FJI,CRI,832509,905169,917200,920422,3979193,4622252,4895242,5123105,0.10864581681011536,0.019519412543760082
Fiji,Cyprus,1,2,2,3,3,2,1,0,0,1,0.5,-2,-0.6666666666666666,-1,-0.5,FJI,CYP,832509,905169,917200,920422,948237,1129686,1187280,1237537,0.10864581681011536,0.08080566480032517
Fiji,Guinea,0,0,0,0,0,3,1,1,1,0,0,1,1,-2,-0.6666666666666666,FJI,GIN,832509,905169,917200,920422,8336967,10270728,11625998,13205153,0.10864581681011536,0.007572801314759473
Laos,Cyprus,1,2,2,3,3,2,1,0,0,1,0.5,-2,-0.6666666666666666,-1,-0.5,LAO,CYP,5430853,6323418,6787419,7319399,948237,1129686,1187280,1237537,0.013662323914846014,0.08080566480032517
Liberia,Thailand,0,0,1,0,1,1,1,1,1,1,1,0,0,0,0,LBR,THA,2895224,4019956,4612329,5087584,63066603,68270489,70294397,71475664,0.01965569511972677,0.0013990775937387583
Maldives,Costa Rica,1,1,1,2,2,1,1,0,0,0,0,-1,-0.5,0,0,MDV,CRI,282507,361575,435582,514438,3979193,4622252,4895242,5123105,0.19438688432814064,0.019519412543760082
Maldives,Ireland,1,2,3,3,2,2,1,0,0,2,0.6666666666666666,-1,-0.5,-1,-0.5,MDV,IRL,282507,361575,435582,514438,3805174,4560155,4701957,4985382,0.19438688432814064,0.020058643449990393
Maldives,Liechtenstein,0,0,0,0,2,2,1,1,1,0,0,-1,-0.5,-1,-0.5,MDV,LIE,282507,361575,435582,514438,33026,35926,37355,38756,0.19438688432814064,2.5802456393848696
Maldives,Lithuania,0,0,0,0,0,0,1,1,1,0,0,1,1,1,1,MDV,LTU,282507,361575,435582,514438,3499536,3097282,2904910,2794885,0.19438688432814064,0.03577964746313354
Maldives,Slovakia,0,0,0,0,0,1,1,1,1,0,0,1,1,0,0,MDV,SVK,282507,361575,435582,514438,5388720,5391428,5423801,5458827,0.19438688432814064,0.01831895387049269
Mongolia,Bolivia (Plurinational State of),0,1,1,1,1,2,1,1,1,1,1,0,0,-1,-0.5,MNG,BOL,2450979,2702520,2964749,3294335,8592656,10223270,11090085,11936162,0.030355139959961572,0.00837790237766545
Myanmar,Estonia,0,0,0,0,0,2,1,1,1,0,0,1,1,-1,-0.5,MMR,EST,45538332,49390988,51483949,53423198,1396985,1331475,1315407,1329522,0.0018718460096679348,0.07521500208345555
Myanmar,Slovenia,0,0,0,0,4,2,1,1,1,0,0,-3,-0.75,-1,-0.5,MMR,SVN,45538332,49390988,51483949,53423198,1988925,2048583,2063531,2102419,0.0018718460096679348,0.04756425812361855
Nepal,Liechtenstein,0,0,0,0,2,4,1,1,1,0,0,-1,-0.5,-3,-0.75,NPL,LIE,24559500,27161567,27610325,29348627,33026,35926,37355,38756,0.0034073144205349027,2.5802456393848696
Papua New Guinea,Bolivia (Plurinational State of),0,1,1,1,1,2,1,1,1,1,1,0,0,-1,-0.5,PNG,BOL,5508297,7583269,8682174,9749640,8592656,10223270,11090085,11936162,0.010256788968618329,0.00837790237766545
Papua New Guinea,Bulgaria,1,2,2,3,3,2,1,0,0,1,0.5,-2,-0.6666666666666666,-1,-0.5,PNG,BGR,5508297,7583269,8682174,9749640,8170172,7395599,7177991,6934015,0.010256788968618329,0.014421659024389188
Papua New Guinea,Estonia,0,0,0,0,1,2,1,1,1,0,0,0,0,-1,-0.5,PNG,EST,5508297,7583269,8682174,9749640,1396985,1331475,1315407,1329522,0.010256788968618329,0.07521500208345555
Papua New Guinea,Greece,3,2,1,3,4,3,1,-2,-0.6666666666666666,-2,-2,-3,-0.75,-2,-0.6666666666666666,PNG,GRC,5508297,7583269,8682174,9749640,10805808,11121341,10820883,10698599,0.010256788968618329,0.009347018240425685
Papua New Guinea,Iceland,0,1,1,1,0,1,1,1,1,1,1,1,1,0,0,PNG,ISL,5508297,7583269,8682174,9749640,281205,318041,330815,366463,0.010256788968618329,0.27287884452182076
Philippines,Guinea,0,0,0,0,0,3,1,1,1,0,0,1,1,-2,-0.6666666666666666,PHL,GIN,77958223,94636700,103031365,112190977,8336967,10270728,11625998,13205153,8.913372775067286e-4,0.007572801314759473
Saudi Arabia,Thailand,0,0,0,0,1,1,1,1,1,0,0,0,0,0,0,SAU,THA,21547390,29411929,32749848,35997107,63066603,68270489,70294397,71475664,0.002778001021026495,0.0013990775937387583
Solomon Islands,Bolivia (Plurinational State of),0,0,0,1,1,2,1,1,1,0,0,0,0,-1,-0.5,SLB,BOL,429978,540394,612660,691191,8592656,10223270,11090085,11936162,0.14467780975157374,0.00837790237766545
Solomon Islands,Ireland,0,1,3,3,2,2,1,1,1,3,1,-1,-0.5,-1,-0.5,SLB,IRL,429978,540394,612660,691191,3805174,4560155,4701957,4985382,0.14467780975157374,0.020058643449990393
South Korea,Sierra Leone,15,14,13,9,6,4,1,-14,-0.9333333333333333,-2,-0.15384615384615385,-5,-0.8333333333333334,-3,-0.75,KOR,SLE,47008111,49554112,51014947,51836239,4584067,6436698,7314773,8233970,0.0019291523059765197,0.012144809854784508
Sri Lanka,Costa Rica,1,1,1,2,2,1,1,0,0,0,0,-1,-0.5,0,0,LKA,CRI,18776371,20668557,21336697,21919000,3979193,4622252,4895242,5123105,0.004562251927551439,0.019519412543760082
Sudan,Thailand,0,0,1,0,1,1,1,1,1,1,1,0,0,0,0,SDN,THA,26298773,33739933,38171178,44440486,63066603,68270489,70294397,71475664,0.002250200414099882,0.0013990775937387583
Timor-Leste,Romania,0,0,0,0,0,1,1,1,1,0,0,1,1,0,0,TLS,ROU,878360,1088486,1205813,1299995,22442971,20246871,19815616,19265250,0.076923372782203,0.005190693087294481
Turkey,Thailand,0,0,1,0,1,1,1,1,1,1,1,0,0,0,0,TUR,THA,64113547,73142150,78218479,83384680,63066603,68270489,70294397,71475664,0.0011992610633032351,0.0013990775937387583
Vanuatu,Sweden,0,0,0,0,1,1,1,1,1,0,0,0,0,0,0,VUT,SWE,192074,245453,276438,311685,8872109,9378126,9799186,10353442,0.32083674222371944,0.00965862367317072
Vietnam,Costa Rica,2,1,1,2,2,1,1,-1,-0.5,-1,-1,-1,-0.5,0,0,VNM,CRI,79001142,87411012,92191398,96648685,3979193,4622252,4895242,5123105,0.0010346752260519635,0.019519412543760082
Zimbabwe,Thailand,0,0,0,0,1,1,1,1,1,0,0,0,0,0,0,ZWE,THA,11834676,12839771,14154937,15669666,63066603,68270489,70294397,71475664,0.006381756956402261,0.0013990775937387583
Bangladesh,Guinea,0,0,0,0,0,1,0,0,0,0,0,0,0,-1,-1,BGD,GIN,129193327,148391139,157830000,167420951,8336967,10270728,11625998,13205153,0,0
Bhutan,Greece,6,4,3,3,2,1,0,-6,-1,-3,-1,-2,-1,-1,-1,BTN,GRC,587207,705516,743274,772506,10805808,11121341,10820883,10698599,0,0
Fiji,Bolivia (Plurinational State of),0,1,2,1,0,0,0,0,0,2,1,0,0,0,0,FJI,BOL,832509,905169,917200,920422,8592656,10223270,11090085,11936162,0,0
Fiji,Bulgaria,0,1,1,2,2,1,0,0,0,1,1,-2,-1,-1,-1,FJI,BGR,832509,905169,917200,920422,8170172,7395599,7177991,6934015,0,0
Fiji,Estonia,0,0,0,0,0,1,0,0,0,0,0,0,0,-1,-1,FJI,EST,832509,905169,917200,920422,1396985,1331475,1315407,1329522,0,0
Fiji,Greece,11,10,9,5,1,0,0,-11,-1,-2,-0.2222222222222222,-1,-1,0,0,FJI,GRC,832509,905169,917200,920422,10805808,11121341,10820883,10698599,0,0
Fiji,Iceland,0,0,0,1,2,1,0,0,0,0,0,-2,-1,-1,-1,FJI,ISL,832509,905169,917200,920422,281205,318041,330815,366463,0,0
Fiji,Slovenia,0,0,0,0,1,1,0,0,0,0,0,-1,-1,-1,-1,FJI,SVN,832509,905169,917200,920422,1988925,2048583,2063531,2102419,0,0
Hong Kong,Austria,154,174,194,215,239,0,0,-154,-1,40,0.20618556701030927,-239,-1,0,0,HKG,AUT,6665000,7024200,7291300,7481000,8011566,8363404,8642699,8916864,0,0
Hong Kong,Czechia,6,9,12,6,0,0,0,-6,-1,6,0.5,0,0,0,0,HKG,CZE,6665000,7024200,7291300,7481000,10255063,10474410,10546059,10697858,0,0
Hong Kong,Denmark,492,492,491,501,0,0,0,-492,-1,-1,-0.002036659877800407,0,0,0,0,HKG,DNK,6665000,7024200,7291300,7481000,5339616,5547683,5683483,5831404,0,0
Hong Kong,Estonia,0,0,0,0,1,0,0,0,0,0,0,-1,-1,0,0,HKG,EST,6665000,7024200,7291300,7481000,1396985,1331475,1315407,1329522,0,0
Hong Kong,Greece,30,40,51,26,0,0,0,-30,-1,21,0.4117647058823529,0,0,0,0,HKG,GRC,6665000,7024200,7291300,7481000,10805808,11121341,10820883,10698599,0,0
Hong Kong,Norway,728,854,884,910,0,0,0,-728,-1,156,0.17647058823529413,0,0,0,0,HKG,NOR,6665000,7024200,7291300,7481000,4490967,4889252,5188607,5379475,0,0
Hong Kong,Sweden,440,523,561,583,0,0,0,-440,-1,121,0.21568627450980393,0,0,0,0,HKG,SWE,6665000,7024200,7291300,7481000,8872109,9378126,9799186,10353442,0,0
Laos,Bolivia (Plurinational State of),0,8,15,8,0,0,0,0,0,15,1,0,0,0,0,LAO,BOL,5430853,6323418,6787419,7319399,8592656,10223270,11090085,11936162,0,0
Laos,Bulgaria,0,0,0,1,1,1,0,0,0,0,0,-1,-1,-1,-1,LAO,BGR,5430853,6323418,6787419,7319399,8170172,7395599,7177991,6934015,0,0
Laos,Iceland,0,0,0,0,0,1,0,0,0,0,0,0,0,-1,-1,LAO,ISL,5430853,6323418,6787419,7319399,281205,318041,330815,366463,0,0
Laos,Mongolia,4,4,5,2,1,1,0,-4,-1,1,0.2,-1,-1,-1,-1,LAO,MNG,5430853,6323418,6787419,7319399,2450979,2702520,2964749,3294335,0,0
Malaysia,Guinea,0,0,0,0,0,1,0,0,0,0,0,0,0,-1,-1,MYS,GIN,22945150,28717731,31068833,33199993,8336967,10270728,11625998,13205153,0,0
Malaysia,Liechtenstein,0,0,0,0,1,1,0,0,0,0,0,-1,-1,-1,-1,MYS,LIE,22945150,28717731,31068833,33199993,33026,35926,37355,38756,0,0
Maldives,Bulgaria,1,1,1,2,2,1,0,-1,-1,0,0,-2,-1,-1,-1,MDV,BGR,282507,361575,435582,514438,8170172,7395599,7177991,6934015,0,0
Maldives,Finland,1,1,1,1,2,2,0,-1,-1,0,0,-2,-1,-2,-1,MDV,FIN,282507,361575,435582,514438,5176209,5363352,5479531,5529543,0,0
Maldives,Greece,8,6,4,4,3,2,0,-8,-1,-4,-1,-3,-1,-2,-1,MDV,GRC,282507,361575,435582,514438,10805808,11121341,10820883,10698599,0,0
Myanmar,Bolivia (Plurinational State of),1,1,0,0,0,0,0,-1,-1,-1,1,0,0,0,0,MMR,BOL,45538332,49390988,51483949,53423198,8592656,10223270,11090085,11936162,0,0
Myanmar,Guinea,0,0,0,0,0,2,0,0,0,0,0,0,0,-2,-1,MMR,GIN,45538332,49390988,51483949,53423198,8336967,10270728,11625998,13205153,0,0
North Korea,Iceland,0,0,0,0,2,0,0,0,0,0,0,-2,-1,0,0,PRK,ISL,23367059,24686435,25258015,25867467,281205,318041,330815,366463,0,0
North Korea,Slovenia,0,0,0,0,2,1,0,0,0,0,0,-2,-1,-1,-1,PRK,SVN,23367059,24686435,25258015,25867467,1988925,2048583,2063531,2102419,0,0
Pakistan,Antigua and Barbuda,7,4,0,0,0,0,0,-7,-1,-7,1,0,0,0,0,PAK,ATG,154369924,194454498,210969298,227196741,75055,85695,89941,92664,0,0
Pakistan,Bahamas,15,13,11,6,0,0,0,-15,-1,-4,-0.36363636363636365,0,0,0,0,PAK,BHS,154369924,194454498,210969298,227196741,325014,373272,392697,406471,0,0
Pakistan,Saint Lucia,8,10,14,8,3,2,0,-8,-1,6,0.42857142857142855,-3,-1,-2,-1,PAK,LCA,154369924,194454498,210969298,227196741,159500,170935,175623,179237,0,0
Solomon Islands,Greece,6,12,19,10,0,0,0,-6,-1,13,0.6842105263157895,0,0,0,0,SLB,GRC,429978,540394,612660,691191,10805808,11121341,10820883,10698599,0,0
Solomon Islands,Iceland,0,0,0,1,1,1,0,0,0,0,0,-1,-1,-1,-1,SLB,ISL,429978,540394,612660,691191,281205,318041,330815,366463,0,0
Solomon Islands,Slovenia,0,0,0,0,0,1,0,0,0,0,0,0,0,-1,-1,SLB,SVN,429978,540394,612660,691191,1988925,2048583,2063531,2102419,0,0
Sri Lanka,Guinea,0,0,0,0,0,2,0,0,0,0,0,0,0,-2,-1,LKA,GIN,18776371,20668557,21336697,21919000,8336967,10270728,11625998,13205153,0,0
Timor-Leste,Czechia,0,1,1,1,0,0,0,0,0,1,1,0,0,0,0,TLS,CZE,878360,1088486,1205813,1299995,10255063,10474410,10546059,10697858,0,0
Timor-Leste,Iceland,0,0,0,0,0,1,0,0,0,0,0,0,0,-1,-1,TLS,ISL,878360,1088486,1205813,1299995,281205,318041,330815,366463,0,0
Uruguay,Mongolia,7,6,7,3,1,1,0,-7,-1,0,0,-1,-1,-1,-1,URY,MNG,3292224,3352651,3402818,3429086,2450979,2702520,2964749,3294335,0,0
Vanuatu,Bolivia (Plurinational State of),2,1,0,0,0,0,0,-2,-1,-2,1,0,0,0,0,VUT,BOL,192074,245453,276438,311685,8592656,10223270,11090085,11936162,0,0
Vanuatu,Czechia,1,2,3,2,1,1,0,-1,-1,2,0.6666666666666666,-1,-1,-1,-1,VUT,CZE,192074,245453,276438,311685,10255063,10474410,10546059,10697858,0,0
Vanuatu,Finland,0,0,0,1,1,1,0,0,0,0,0,-1,-1,-1,-1,VUT,FIN,192074,245453,276438,311685,5176209,5363352,5479531,5529543,0,0
Vanuatu,Hungary,0,0,0,0,0,1,0,0,0,0,0,0,0,-1,-1,VUT,HUN,192074,245453,276438,311685,10210971,10000023,9843028,9750149,0,0
Vanuatu,Ireland,0,1,2,2,1,1,0,0,0,2,1,-1,-1,-1,-1,VUT,IRL,192074,245453,276438,311685,3805174,4560155,4701957,4985382,0,0
Vanuatu,Norway,0,0,0,0,2,2,0,0,0,0,0,-2,-1,-2,-1,VUT,NOR,192074,245453,276438,311685,4490967,4889252,5188607,5379475,0,0
Vanuatu,Slovakia,0,0,0,0,0,1,0,0,0,0,0,0,0,-1,-1,VUT,SVK,192074,245453,276438,311685,5388720,5391428,5423801,5458827,0,0
Vietnam,Sierra Leone,0,1,1,1,1,0,0,0,0,1,1,-1,-1,0,0,VNM,SLE,79001142,87411012,92191398,96648685,4584067,6436698,7314773,8233970,0,0
